cancel	'kænsl	'kænsl	取消， 撤销； 删去
explosive	ɪk'spləusɪv	ɪk'splosɪv; ɪk'splozɪv	爆炸的； 极易引起争论的 / 炸药
numerous	'njuːmərəs	'numərəs	众多的
govern	'gʌvn	'ɡʌvɚn	居支配地位， 占优势 / 统治，治理，支配
analyse	'ænəlaɪz	'æn(ə)laɪz	分析； 分解； 解析
discourage	dɪs'kʌrɪdʒ	dɪs'kɝɪdʒ	使泄气， 使灰心； 阻止， 劝阻
resemble	rɪ'zembl	rɪ'zɛmbl	像， 类似于
remote	rɪ'məut	rɪ'mot	遥远的； 偏僻的； 关系疏远的； 脱离的； 微乎其微的； 孤高的， 冷淡的； 遥控的
salary	'sæləri	'sæləri	薪金， 薪水
pollution	pə'luːʃn	pə'luʃən	污染， 污染物
pretend	prɪ'tend	prɪ'tɛnd	装作， 假装
kettle	'ketl	'kɛtl	水壶
wreck	rek	rɛk	失事；残骸；精神或身体已垮的人 / 破坏
drunk	drʌŋk	drʌŋk	醉的； 陶醉的
calculate	'kælkjuleɪt	'kælkjulet	计算； 估计； 计划
persistent	pə'sɪstənt	pə'zɪstənt	坚持的， 不屈不挠的； 持续不断的； 反复出现的
sake	seɪk	sek	缘故， 理由
conceal	kən'siːl	kən'sil	把…隐藏起来， 掩盖， 隐瞒
audience	'ɔːdiəns	'ɔdɪəns	听众， 观众， 读者
meanwhile	'miːnwaɪl	'minwaɪl	与此同时
possess	pə'zes	pə'zɛs	占用， 拥有
competent	'kɒmpɪtənt	'kɑmpɪtənt	有能力的， 能胜任的
investment	ɪn'vestmənt	ɪn'vɛstmənt	投资， 投资额； 投入
neutral	'njuːtrəl	'nʊtrəl	中立的； 中性的
scratch	skrætʃ	skrætʃ	抓，搔，扒；刮，擦；刻出 / 抓痕， 划痕； 抓， 搔， 刮
optional	'ɒpʃənl	'ɑpʃənl	可以任选的
require	rɪ'kwaɪə	rɪ'kwaɪr	需要； 要求； 命令
circular	'sɜːkjələ	'sɝkjəlɚ	圆的；循环的；兜圈子的 / 通知， 通告
analysis	ə'næləsɪs	ə'næləsɪs	分析， 分析报告； 分解； 解析
click	klɪk	klɪk	发出咔嗒声；点击 / 咔嗒声
fashionable	'fæʃnəbl	'fæʃnəbl	流行的， 时髦的
devise	dɪ'vaɪz	dɪ'vaɪz	设计， 发明
apparent	ə'pærənt	ə'pærənt	表面上的， 明显的
journalist	'dʒɜːnəlɪst	ˈdʒɝ​nlɪst	新闻工作者， 新闻记者
exposure	ɪk'spəuʒə	ɪk'spoʒɚ	暴露， 揭露； 曝光
temper	'tempə	'tɛmpɚ	韧度；心情，情绪 / 调和， 使缓和； 【冶】使回火
protective	prə'tektɪv	prə'tɛktɪv	保护的， 防护的
sideways	'saɪdweɪz	'saɪdwez	从一边， 向一边； 在一边； 斜着， 侧身
multicultural	ˌmʌlti'kʌltʃərəl	'mʌltɪ'kʌltʃərəl	融合多种文化的
object	'ɒbdʒɪkt; -dʒekt	'ɑbdʒɛkt	反对， 不赞成 / 实物， 物体； 目的， 目标； 对象， 客体； 宾语
humble	'hʌmbl	'hʌmbl	谦逊的； 地位低下的； 简陋的
chapter	'tʃæptə	'tʃæptɚ	章， 回， 篇
harbour	'hɑːbə	hɑrbɚ	海港，港口 / 庇护； 心怀
independent	ˌɪndɪ'pendənt	'ɪndɪ'pɛndənt	独立的， 自主的； 无偏见的； 不相关联的
carriage	'kærɪdʒ	'kærɪdʒ	客车厢， 四轮马车
cliff	klɪf	klɪf	悬崖， 峭壁
infinite	'ɪnfɪnət	'ɪnfɪnət	无限的； 无穷的
concede	kən'siːd	kən'sid	承认， 承认…为真； 承认失败； 允许， 让予； 让步， 认输
elect	ɪ'lekt	ɪ'lɛkt	选举， 推选； 选择
weekly	'wiːkli	'wikli	每周 / 每周的
result	rɪ'zʌlt	rɪ'zʌlt	发生； 结果 / 结果；成果；比分
golf	gɒlf	gɔlf	高尔夫球运动
selfish	'selfɪʃ	'sɛlfɪʃ	自私的， 利己的
sexism	'seksɪzəm	'sɛk'sɪzəm	性别偏见， 性别歧视
commission	kə'mɪʃn	kə'mɪʃən	委任状；委员会；佣金，回扣；授权，委托 / 委任， 委托
headline	'hedlaɪn	'hɛdlaɪn	大字标题； 新闻提要
connect	kə'nekt	kə'nɛkt	连接， 结合， 联系； 给…接通电话
rational	'ræʃnəl	'ræʃnəl	理性的， 理智的； 合理的
policy	'pɒləsi	'pɑləsi	政策， 方针； 保险单
editorial	ˌedɪ'tɔːriəl	,ɛdɪ'tɔrɪəl	编辑的，主笔的，编者的；社论的，社论式的 / 社论， 重要评论
resume	rɪˈzjuːm; ˈrɛzjʊmeɪ		重新开始， 继续， 恢复 / 摘要， 概要； 简历
rebuild	ˌriː'bɪld	,ri'bɪld	重建， 改造； 复原
committee	kə'mɪti	kə'mɪti	委员会， 全体委员
namely	'neɪmli	'nemli	即， 也就是
artistic	ɑː'tɪstɪk	ɑr'tɪstɪk	艺术的， 艺术家的； 富有艺术性的， 精美的； 精彩的
union	'juːnɪən	'junɪən	工会， 联盟； 联合， 团结； 一致
plentiful	'plentɪfl	'plɛntɪfəl	丰富的， 充足的； 大量的
halt	hɔːlt	hɔlt	停止，立定 / 停住
component	kəm'pəunənt	kəm'ponənt	组成的， 构成的 / 组成部分，部件，组件
consultant	kən'sʌltənt	kən'sʌltənt	顾问； 会诊医师， 专科医生
sunset	'sʌnset	'sʌnsɛt	日落； 晚霞
obvious	'ɒbviəs	'ɑbvɪəs	明显的
illustration	ˌɪlə'streɪʃn	,ɪlə'streʃən	说明， 图解， 例证
disguise	dɪs'gaɪz	dɪs'ɡaɪz	假扮，化装，伪装；掩盖，掩饰 / 用来伪装的东西； 伪装， 掩饰
wrap	ræp	ræp	裹，包，捆 / 披肩
surgery	'sɜːdʒəri	'sɝdʒəri	外科， 外科手术； 手术室
liberal	'lɪbərəl	'lɪbərəl	心胸宽大的， 慷慨的； 自由的， 自由主义的
violent	'vaɪələnt	'vaɪələnt	暴力引起的， 暴力的； 猛烈的， 剧烈的
harmony	'hɑːməni	'hɑrməni	调和， 协调， 和谐
resolve	rɪ'zɒlv	rɪ'zɑlv	解决， 解答； 决定， 决意
chill	tʃɪl	tʃɪl	变冷，感到冷 / 寒冷， 寒气； 风寒， 寒战
confront	kən'frʌnt	kən'frʌnt	迎面遇到， 遭遇； 勇敢地面对， 正视； 使对质， 使当面对证
dominate	'dɒmɪneɪt	'dɑmɪnet	拥有优势 / 在…中占首要地位；支配，统治，控制；耸立于，俯视
imitate	'ɪmɪteɪt	'ɪmɪtet	模仿， 仿效， 仿制
faithful	'feɪθfl	'feθfəl	忠诚的； 如实的； 尽职的
reproduce	ˌriːprə'djuːs	,riprə'dus	复制， 再现； 繁殖， 生殖
institution	ˌɪnstɪ'tjuːʃn	,ɪnstɪ'tuʃən	协会； 制度， 习俗
pad	pæd	pæd	垫，衬垫；便笺本；发射台，直升机起落场 / 填塞
provocation	ˌprɒvə'keɪʃn	,prɑvə'keʃən	激怒， 刺激； 挑衅， 挑拨
ambition	æm'bɪʃn	æm'bɪʃən	雄心， 抱负； 野心； 期望得到的东西
scholarship	'skɒləʃɪp	'skɑlɚʃɪp	奖学金； 学问， 学识
exceed	ɪk'siːd	ɪk'sid	超过， 胜过， 超出
besides	bɪ'saɪdz	bɪ'saɪdz	而且 / 除…之外
preposition	ˌprepə'zɪʃn	,prɛpə'zɪʃən	介词
enlarge	ɪn'lɑːdʒ	ɪn'lɑrdʒ	扩大， 扩展， 放大
implement	'ɪmplɪm(ə)nt	'ɪmplɪmɛnt	工具， 器具， 用具 / 使生效， 履行， 实施
export	ˈekspɔːt；ɪkˈ-	ˈekspɔːrt；ɪkˈ-	输出， 出口 / 输出， 出口； 输出品， 出口额
Christ	kraɪst	kraist	基督， 救世主
murder	'mɜːdə	'mɝdɚ	谋杀，凶杀；谋杀罪 / 谋杀；杀害
pat	pæt	pæt	非常恰当的， 适时的 / 轻拍
fantasy	'fæntəsi	'fæntəsi	想象， 幻想； 想象的产物
horsepower	'hɔːspauə	'hɔrs'paʊɚ	马力
visibility	ˌvɪzə'bɪləti	'vɪzə'bɪləti	可见度， 能见度； 可见性， 明显性
invitation	ˌɪnvɪ'teɪʃn	ˌɪnvɪˈteɪʃn	邀请， 招待； 请柬； 吸引， 诱惑
paw	pɔː	pɔ	用爪子抓， 用蹄扒； 翻找 / 爪子
enormous	ɪ'nɔːməs	ɪ'nɔrməs	巨大的， 庞大的
moisture	'mɔɪstʃə	'mɔɪstʃɚ	潮湿， 湿气
toast	təust	tost	烤面包；祝酒，祝酒词 / 烘， 烤； 向…祝酒， 为…干杯
frustrate	frʌ'streɪt	'frʌstret	使沮丧， 使灰心； 挫败， 使受挫折
external	ɪk'stɜːnl	ɪk'stɝnl	外部的， 外面的
aside	ə'saɪd	ə'saɪd	在旁边， 到旁边
circumstance	'sɜːkəmstəns	ˈsɝ​kəmˌstəns	情况， 条件； 境遇， 境况； 经济情况
revise	rɪ'vaɪz	rɪ'vaɪz	修订， 修改； 复习
authority	ɔː'θɒrəti	ə'θɔrəti	官方； 权力； 当权者， 行政管理机构； 权威， 专家
creature	'kriːtʃə	'kritʃɚ	创造物， 产物； 生物， 动物， 家畜
harm	hɑːm	hɑrm	伤害， 损害
semiconductor	ˌsemikən'dʌktə	,sɛmɪkən'dʌktɚ	半导体
rope	rəup	rop	绳，索 / 用绳捆
provided	prə'vaɪdɪd	prə'vaɪdɪd	假如， 若是
instrument	'ɪnstrəmənt	'ɪnstrəmənt	仪器， 工具； 乐器
gasoline	'gæsəliːn	'gæsəlin	汽油
indispensable	ˌɪndɪ'spensəbl	'ɪndɪ'spɛnsəbl	必不可少的， 必需的
medium	'miːdiəm	'midɪəm	中等的 / 媒体；媒介物，传导体
lens	lenz	lɛnz	透镜， 镜片， 镜头
wisdom	'wɪzdəm	'wɪzdəm	智慧， 才智； 名言
fatal	'feɪtl	'fetl	致命的， 命运的； 重大的， 决定性的
nowhere	'nəuhweə	'no'wɛr	任何地方都不
motive	'məutɪv	'motɪv	动机， 目的
romantic	rəu'mæntɪk	ro'mæntɪk	浪漫的； 多情的； 有浪漫色彩的， 传奇性的； 不切实际的， 空想的
motivate	'məutɪveɪt	'motə'vet	作为…的动机； 激励， 激发
spoil	spɔɪl	spɔɪl	损坏，糟蹋；宠坏，溺爱；变质 / 战利品， 掠夺物
airline	'eəlaɪn	'ɛrlaɪn	航空公司； 航线
multiply	'mʌltɪplaɪ	'mʌltɪplaɪ	增加， 繁殖； 乘
ridge	rɪdʒ	rɪdʒ	脊， 山脊； 垄， 埂， 脊状突起
pilot	'paɪlət	'paɪlət	试验性的， 试点的 / 引航员；飞行员 / 驾驶；为引航；试验，试用
umbrella	ʌm'brelə	ʌm'brɛlə	伞， 雨伞
approval	ə'pruːvl	əˈpruvl	赞成， 同意， 批准
mobile	'məubaɪl	ˈməʊbl;mobil	运动的； 流动的； 多变的
perform	pə'fɔːm	pɚ'fɔrm	做， 履行， 完成； 表演， 演出； 工作情况， 表现
multiple	'mʌltɪpl	'mʌltəpl	复合的，多重的，多样的 / 倍数
peak	piːk	pik	达到高峰， 达到最大值 / 最大值的，高峰的 / 山顶，顶点
evolution	ˌiːvə'luːʃn; ˌevə'luːʃn	ˌɛvəˈluʃən; (occas.) ˌ ivəˈluʃən	进化， 演化， 发展
portrait	'pɔːtrət; 'pɔːtreɪt	'pɔrtrɪt	肖像， 画像
halfway	ˌhɑːf'weɪ	,hæf'we	半路地； 在中途， 在半途 / 中途的；部分的；不彻底的
expose	ɪk'spəuz	ɪk'spoz；ek-	使接触； 揭露
concentrate	'kɒnsntreɪt	'kɑnsn'tret	全神贯注，全力以赴；集中，聚集；浓缩 / 浓缩物， 浓缩液
magnet	'mægnət	'mægnɪt	磁铁， 磁体； 有吸引力的人或事物
explosion	ɪk'spləuʒn	ɪk'sploʒən	爆炸， 爆发， 炸裂； 激增， 扩大
weld	weld	wɛld	焊接， 熔接
up-to-date	ˌʌptə'deɪt	'ʌptə 'det	直到最近的， 现代的； 跟上时代的
complaint	kəm'pleɪnt	kəm'plent	抱怨， 怨言； 控告
translation	træns'leɪʃn; trænz'leɪʃn	træns'leʃən	翻译； 译文， 译本
cancer	'kænsə	'kænsɚ	癌， 癌症； 肿瘤
personnel	ˌpɜːsə'nel	,pɝsə'nɛl	人员， 员工
hopeless	'həupləs	ˈhoʊpləs	没有希望的， 绝望的
outlook	'autluk	'aʊtlʊk	观点， 看法； 展望， 前景
fountain	'fauntən	'faʊntn	泉水； 喷泉； 源泉
offense	ə'fens	ə'fɛns	犯规， 违法行为； 冒犯， 得罪
breadth	bredθ	brɛdθ	宽度； 幅度， 幅面
catalog	'kætəlɒg	'kætəlɔg	目录，目录册；一系列 / 将…编入目录， 将编目
channel	'tʃænl	'tʃænl	海峡， 水道， 航道； 渠道， 途径； 频道
focus	'fəukəs	'fokəs	聚焦；集中 / 焦点； 中心
invisible	ɪn'vɪzəbl	ɪn'vɪzəbl	看不见的， 无形的
entire	ɪn'taɪə	ɪn'taɪɚ	全部的， 整个的
pea	piː	pi	豌豆
pill	pɪl	pɪl	药丸
wrist	rɪst	rɪst	腕， 腕关节
approach	ə'prəutʃ	ə'protʃ	向…靠近 / 靠近
myth	mɪθ	mɪθ	杜撰出来的人； 神话
flour	'flauə	'flaʊr	面粉； 粉， 粉状物质
implication	ˌɪmplɪ'keɪʃn	'ɪmplɪ'keʃən	含意， 暗示， 暗指； 卷入， 牵连
camel	'kæml	'kæml	骆驼
fierce	fɪəs	fɪrs	凶猛的； 狂热的
bump	bʌmp	bʌmp	碰，撞；颠簸着前进 / 碰撞， 猛撞； 肿块； 隆起物
reservation	ˌrezə'veɪʃn	,rɛzɚ'veʃən	预订； 保留； 犹豫； 保留地
per	pə	pɚ	每， 每一
proceed	prə'siːd	pro'sid	继续进行； 行进， 前进
considering	kən'sɪdərɪŋ	kən'sɪdərɪŋ	鉴于， 考虑到， 顾及
corporation	ˌkɔːpə'reɪʃn	,kɔrpə'reʃən	公司， 企业， 社团
loyalty	'lɔɪəlti	'lɔɪəlti	忠诚， 忠心
bulb	bʌlb	bʌlb	电灯泡， 球状物
dismiss	dɪs'mɪs	dɪs'mɪs	不再考虑； 解雇， 解散； 驳回
propose	prə'pəuz	prə'poz	提议， 建议， 提出； 提名， 推荐； 打算， 计划； 求婚
intelligence	ɪn'telɪdʒəns	ɪn'tɛlɪdʒəns	智力； 理解力； 情报
reform	rɪ'fɔːm	rɪ'fɔrm	改革， 改良， 改造； 改正， 改过自新
draught	drɑːft	drɑft	穿堂风，冷风 / 〔啤酒〕桶装的，散装的
daylight	'deɪlaɪt	'delaɪt	白昼， 日光， 黎明
install	ɪn'stɔːl	ɪn'stɔl	安装， 设置； 使就职， 任命
integration	ˌɪntɪ'greɪʃn	'ɪntə'greʃən	综合
indication	ˌɪndɪ'keɪʃn	,ɪndɪ'keʃən	指示， 表示， 表明； 象征， 迹象
bulk	bʌlk	bʌlk	变得越来越大； 使更大 / 物体；体积；大批
coach	kəutʃ	kotʃ	长途公共汽车；教练，指导；旅客车厢 / 训练， 指导， 辅导
despair	dɪ'speə	dɪ'spɛr	绝望 / 绝望，感到无望
champion	'tʃæmpiən	'tʃæmpɪən	冠军， 得胜者； 捍卫者， 拥护者
gum	gʌm	ɡʌm	口香糖； 树胶
circuit	'sɜːkɪt	'sɝkɪt	电路， 线路； 环行， 巡行
pine	paɪn	paɪn	消瘦， 衰弱； 痛苦， 悲哀； 渴望 / 松树，松木
magnificent	mæg'nɪfɪsnt	mæg'nɪfəsnt	宏伟的， 壮丽的； 华丽的； 极好的
guy	gaɪ	ɡai	家伙， 伙计
respectively	rɪ'spektɪvli	rɪ'spɛktɪvli	各自地， 各个地， 分别地
protection	prə'tekʃn	prə'tɛkʃən	保护， 防护
pint	paɪnt	paɪnt	品脱
restrict	rɪ'strɪkt	rɪ'strɪkt	限制， 约束， 限定
instant	'ɪnstənt	'ɪnstənt	立即的； 紧急的； 可以速食的 / 瞬间
conjunction	kən'dʒʌŋkʃn	kən'dʒʌŋkʃən	接合， 连接， 联合； 连词
peer	pɪə	pɪr	仔细看， 费力地看 / 同龄人，同等地位的人；贵族
orderly	'ɔːdəli	'ɔrdɚli	整洁的； 有秩序的
costly	'kɒstli	'kɔstli	昂贵的， 价值高的
roast	rəust	rost	烤，炙，烘 / 烤过的， 烘过的 / 烤肉
violence	'vaɪələns	'vaɪələns	猛烈， 激烈； 暴力
succession	sək'seʃn	sək'sɛʃən	连续； 一连串； 接替， 继任， 继承
accordingly	ə'kɔːdɪŋli	ə'kɔrdɪŋli	因此， 所以； 照着
consequence	'kɒnsɪkwəns	'kɑnsəkwɛns	结果， 后果； 重要， 重大
product	'prɔdʌkt; 'prɔdəkt	'prɑdʌkt	产品， 产物； 乘积
particularly	pə'tɪkjələli	pɚ'tɪkjəlɚlɪ	特别， 尤其
dominant	'dɒmɪnənt	'dɑmɪnənt	占优势的， 支配的， 统治的； 居高临下的， 高耸的
heading	'hedɪŋ	'hɛdɪŋ	标题， 题词， 题名； 新闻提要
lover	'lʌvə	'lʌvɚ	爱好者； 情人
vinegar	'vɪnɪgə	'vɪnɪɡɚ	醋
intellectual	ˌɪntə'lektʃuəl	,ɪntə'lɛktʃuəl	智力的 / 知识分子
cheat	tʃiːt	tʃit	欺骗；作弊；哄，行骗 / 欺骗， 欺骗行为； 骗子
framework	'freɪmwɜːk	'fremwɝk	框架， 结构； 准则； 体系
undoubtedly	ˌʌn'dautɪdli	ʌn'daʊtɪdli	毋庸置疑地， 肯定地
infect	ɪn'fekt	ɪn'fɛkt	传染， 感染； 影响
tide	taɪd	taɪd	潮， 潮汐； 潮流， 趋势
prohibit	prə'hɪbɪt	prə'hɪbɪt	禁止， 不准
bacteria	bæk'tɪəriə	bæk'tɪrɪə	细菌
minor	'maɪnə	'maɪnɚ	辅修 / 较小的，较少的；次要的 / 未成年人；辅修科目
arrow	'ærəu	'æro	箭， 箭状物； 箭头符号
cop	kɒp	kɑp	警察
fuel	'fjuːəl	'fjuəl	加燃料； 加油 / 燃料，燃料剂 / 给…加燃料；刺激
hostile	'hɒstaɪl	ˈhɑstl	敌方的； 不友善的
aeroplane	'eərəpleɪn	ˈɛrəˌplen	飞机
manner	'mænə	'mænɚ	方式； 态度； 风度； 礼貌， 规矩
employee	ɪm'plɔɪɪː	ɪmˈplɔɪi;ɛmplɔɪˈi	受雇者， 雇员， 雇工
associate	ə'səʊʃɪeɪt; -sɪeɪt	ə'soʃɪet	结合； 交往 / 副的 / 把…联系在一起；使联合 / 伙伴，同事
pray	preɪ	pre	祈祷， 祈求； 请求， 恳求
lad	læd	læd	男孩， 小伙子
crawl	krɔːl	krɔl	爬， 爬行； 缓慢地行进
identical	aɪ'dentɪkl	aɪ'dɛntɪkl	完全相同的， 同一的
lag	læg	læɡ	走得慢 / 落后
towel	'tauəl	'taʊəl	毛巾， 手巾
charity	'tʃærəti	'tʃærəti	救济金， 施舍物； 慈善团体， 慈善事业； 宽大， 宽容
academic	ˌækə'demɪk	,ækə'dɛmɪk	学院的； 学术的； 纯理论的， 不切实际的
function	'fʌŋkʃn	'fʌŋkʃən	运作， 运行 / 功能；职务，职责
employer	ɪm'plɔɪə	ɪm'plɔɪɚ	雇佣者， 雇主
pit	pɪt	pɪt	地洞，坑；煤矿，矿井 / 使有坑
lap	læp	læp	舔； 拍打 / 膝部；一圈，一段
mineral	'mɪnərəl	'mɪnərəl	矿物， 矿石， 矿物质
stock	stɒk	stɑk	常用的， 常备的 / 原料，库存品；股本，公债；世系，血统；汤汁；家畜，牲畜 / 储备
representative	ˌreprɪ'zentətɪv	'rɛprɪ'zɛntətɪv	有代表性的， 典型的 / 代表，代理人
suspend	sə'spend	sə'spɛnd	暂停， 终止； 吊， 悬
pigeon	'pɪdʒɪn	'pɪdʒɪn	鸽子
well-known	ˌwel'nəun	,wɛl'non	众所周知的， 著名的
beneath	bɪ'niːθ	bɪˈniːθ	在下方， 在底下 / 在…下方；低于，次于；在…掩盖下；连…也不值得，有失…的身份
terror	'terə	'tɛrɚ	恐怖， 惊骇； 引起恐怖的人或事
comparison	kəm'pærɪsn	kəm'pærɪsn	比较， 对照； 比拟， 比喻
surge	sɜːdʒ	sɝdʒ	蜂拥而出；洋溢，奔放；汹涌，奔腾 / 大浪， 波涛； 高涨； 汹涌
lest	lest	lɛst	唯恐， 以免
heroic	hə'rəuik	hə'roɪk	英雄的； 英勇的
sway	sweɪ	swe	摇，摇动；动摇 / 摇摆， 摇动； 起支配作用的影响
basis	'beɪsɪs	'besɪs	基础， 根据； 原则
tutor	'tjuːtə	'tʊtɚ	当…导师， 当…家庭教师 / 导师；家庭教师，私人教师
senator	'senətə	'sɛnətɚ	参议员
adventure	əd'ventʃə	əd'vɛntʃɚ	奇遇； 冒险， 冒险活动
successive	sək'sesɪv	sək'sɛsɪv	连续的， 接连的
condition	kən'dɪʃn	kən'dɪʃən	状况， 状态； 环境
thirsty	'θɜːsti	'θɝsti	渴的； 渴望的
ceremony	'serəməni	ˈsɛrəˌmoʊni	典礼， 仪式， 礼节
obligation	ˌɒblɪ'geɪʃn	,ɑblɪ'ɡeʃən	义务， 责任
improve	ɪm'pruːv	ɪm'pruv	变得更好； 改善； 提高
gym	dʒɪm	dʒɪm	体育馆； 健身房
rarely	'reəli	'rɛrli	很少， 难得
evil	'iːvl	'ivl	坏的 / 邪恶，祸害
governor	'gʌvənə	'ɡʌvɚnɚ	州长； 主管人员； 理事， 董事
twist	twɪst	twɪst	缠绕，盘绕；转动，旋动；捻，搓；歪曲，曲解；扭歪，扭伤；曲折前进；转身 / 扭弯； 转折， 转变； 弯曲， 曲折处
locate	ləu'keɪt	ˈloˌket; loˈket	探明， 找出； 把…设置在， 使…坐落于
unite	ju'naɪt	ju'naɪt	联合， 统一
lavatory	'lævətri	'lævətɔri	盥洗室， 厕所
exterior	ɪk'stɪəriə	ɪk'stɪrɪɚ	外部的；对外的 / 外部， 外表
technique	tek'niːk	tɛk'nik	技术， 技巧， 技能
combat	'kɒmbæt	'kɑmbæt	战争，斗争，格斗 / 与…斗争， 与…战斗
troop	truːp	trʊp	成群结队而行 / 军队，部队；一群，大量
scenery	'siːnəri	'sinəri	风景， 景色； 舞台布景
unity	'juːnəti	'junəti	单一， 统一， 团结； 和睦， 协调
effective	ɪ'fektɪv	ɪ'fɛktɪv	有效的； 有影响的
pursue	pə'sjuː	pə'sʊ	继续； 从事； 追赶， 追踪； 追求
similarly	'sɪmələli	'sɪməlɚli	类似地， 相似地
convey	kən'veɪ	kən've	表达， 传递； 运送， 输送
muscle	'mʌsl	'mʌsl	肌肉， 体力； 力量， 实力
design	dɪ'zaɪn	dɪ'zaɪn	设计；预定，指定 / 设计， 构想； 图样； 企图
extra	'ekstrə	'ɛkstrə	特别地 / 额外的；特别的 / 额外的事物， 额外费用
generous	'dʒenərəs	'dʒɛnərəs	慷慨的； 宽厚的； 大量的
victim	'vɪktɪm	'vɪktɪm	牺牲者， 受害者
possibility	ˌpɒsə'bɪləti	,pɑsə'bɪləti	可能； 可能的事
lane	leɪn	len	小路； 跑道； 航道， 航线
garlic	'gɑːlɪk	'ɡɑrlɪk	大蒜
chief	tʃiːf	tʃif	主要的，为首的；总的 / 首领， 长官； 酋长， 族长
accord	ə'kɔːd	ə'kɔrd	相符合； 相一致 / 一致，符合；谅解，协议 / 使符合；使一致；调节；授予，赠与，给予
aircraft	'eəkrɑːft	'ɛr'kræft	飞机， 飞行器
automatic	ˌɔːtə'mætɪk	'ɔtə'mætɪk	自动的，机械的；不假思索的，无意识的；必然的，自然的 / 自动手枪； 有自动装置的汽车
doubtful	'dautfl	'daʊtfəl	难以预测的； 怀疑的
despite	dɪ'spaɪt	dɪ'spaɪt	不管， 不顾
opening	'əupnɪŋ	'opənɪŋ	开首的，开始的 / 口子， 洞， 孔； 开始； 空缺
industrial	ɪn'dʌstriəl	ɪn'dʌstrɪəl	工业的， 产业的
obey	ə'beɪ	ə'be	顺从， 服从
conduct	'kɒndʌkt	kən'dʌkt	举止， 行为； 指导； 管理； 实施 / 进行； 管理， 指挥， 引导； 传输， 传导
stable	'steɪbl	'stebl	稳定的，不变的；沉稳的，持重的 / 厩， 马厩， 牛棚
lamb	læm	læm	羔羊， 小羊； 羔羊肉
pillow	'pɪləu	'pɪlo	枕头
harness	'hɑːnɪs	'hɑrnɪs	治理；给上挽具 / 马具， 挽具
fantastic	fæn'tæstɪk	fæn'tæstɪk	极好的， 极出色的， 了不起的； 极大的； 难以相信的； 异想天开的， 不实际的； 奇异的， 古怪的
sketch	sketʃ	skɛtʃ	绘…的略图， 画…的素描； 概述 / 略图；梗概；素描，速写
tidy	'taɪdi	'taɪdi	整洁的，整齐的 / 整洁， 整齐
respond	rɪ'spɒnd	rɪ'spɑnd	回答， 答复； 作出反应， 响应
incident	'ɪnsɪdənt	'ɪnsɪdənt	发生的事， 事件
maintenance	'meɪntənəns	'mentənəns	维持； 保养； 抚养费
marry	'mæri	'mæri	娶， 嫁； 为…证婚； 结婚， 结合
decay	dɪ'keɪ	dɪ'ke	腐烂；衰败 / 腐烂
absorb	əb'sɔːb; əb'zɔːb	æbˈsɔrb; æbˈzɔrb; əbˈsɔrb	吸收； 吸引…的注意， 使全神贯注； 把…并入， 同化
supply	sə'plaɪ	sə'plaɪ	供给， 供应
concern	kən'sɜːn	kən'sɝn	关切的事，有关的事；关心，挂念；关系，关联；公司，企业 / 涉及， 有关； 使关心， 使担心
circulate	'sɜːkjəleɪt	'sɝkjəlet	循环， 流通； 流传， 散布， 传播
liberty	'lɪbəti	'lɪbɚti	自由； 许可， 准许； 过于随便， 放肆
liable	'laɪəbl	'laɪəbl	易于…的； 可能的
cargo	'kɑːgəu	'kɑrɡo	船货， 货物
confidential	ˌkɒnfɪ'denʃl	,kɑnfɪ'dɛnʃl	秘密的， 机密的； 亲信的
drift	drɪft	drɪft	漂流，漂泊 / 漂流； 大意， 主旨； 趋势
element	'elɪmənt	'ɛləmənt	成分， 要素， 元素； 基础， 纲要； 自然力
chaos	'keɪɒs	'keɑs	混乱， 紊乱
mankind	ˌmæn'kaɪnd	mæn'kaɪnd	人类
abundant	ə'bʌndənt	ə'bʌndənt	丰富的， 富裕的； 大量的， 充足的
pace	peɪs	pes	踱步 / 步，步速；速度；节奏
exclaim	ɪk'skleɪm	ɪk'sklem	呼喊， 惊叫
probable	'prɒbəbl	'prɑbəbl	很可能的， 大概的
forecast	'fɔːkɑːst	'fɔrkæst	预测， 预报 / 预测，预报
uncover	ʌn'kʌvə	ʌn'kʌvɚ	揭露， 暴露； 揭开…的盖子
recognize	'rekəgnaɪz	ˈrɛkəɡˌnaɪz	认出， 识别； 承认； 赏识， 表彰， 报偿
pack	pæk	pæk	捆扎，把…打包；使挤在一起，塞满 / 包， 小盒
restraint	rɪ'streɪnt	rɪ'strent	抑制， 限制， 克制； 约束措施， 约束条件
input	'ɪnput	'ɪn'pʊt	输入；投入的资金；输入的数据 / 把…输入计算机
cue	kjuː	kju	暗示，信号；提示 / 提示； 暗示
volt	vəult	volt	伏特， 伏
reality	ri'æləti	rɪ'æləti	现实， 实际； 真实
stereotype	'steriətaɪp	'stɛrɪətaɪp	陈规，老套，固定的模式；铅版 / 把…浇铸成铅版； 对…形成固定看法
enroll	ɪn'rəul	ɪn'rol	入学，加入 / 招收， 吸收
offend	ə'fend	ə'fɛnd	冒犯， 伤害…的感情； 使厌恶； 违反
molecule	'mɒlɪkjuːl	'mɑlɪkjul	分子
resign	rɪ'zaɪn	rɪ'zaɪn	辞职 / 辞去， 放弃； 使听从， 使顺从
bathe	beɪð	beð	洗澡； 游泳
workman	'wɜːkmən	'wɝkmən	工人， 劳动者， 工匠
sophisticated	sə'fɪstɪkeɪtɪd	sə'fɪstɪketɪd	老于世故的； 高级的； 精密的， 复杂的； 高雅的
sunrise	'sʌnraɪz	'sʌnraɪz	日出； 朝霞
entertainment	ˌentə'teɪnmənt	ˌɛntɚ'tenmənt	娱乐， 文娱节目， 表演会； 招待， 款待， 请客
document	'dɒkjumənt	dɑkjəmənt	公文，文件；证件 / 用文件等证明
starve	stɑːv	stɑrv	挨饿， 饿死
battery	'bætri	'bæt(ə)rɪ	电池， 蓄电池； 排炮， 炮组； 一系列， 一套
chase	tʃeɪs	tʃeis	追逐， 追赶； 追求
accident	'æksɪdənt	'æksədənt	意外， 事故
marine	mə'riːn	mə'rin	海的， 海生的； 海事的， 海军的， 海运的 / 海军陆战队士兵
clay	kleɪ	kle	黏土， 泥土； 肉体
anyway	'eniweɪ	'ɛnɪ'we	无论如何， 至少； 不论以何种方式， 无论从什么角度
promote	prə'məut	prə'mot	促进， 增进， 发扬； 提升； 宣传， 推销
routine	ruː'tiːn	rʊ'tin	例行的， 常规的 / 例行公事，惯例，惯常的程序
attack	ə'tæk	ə'tæk	攻击，打击；突然发作 / 攻击， 进攻
humour	'hjuːmə	'hju:mə	幽默， 诙谐， 幽默感
divorce	dɪ'vɔːs	dɪ'vɔrs	离婚； 分离， 脱离 / 离婚，离异
currency	'kʌrənsi	ˈkɜrənsi	通货， 货币； 通行， 流行
canal	kə'næl	kə'næl	运河， 沟渠； 管
attach	ə'tætʃ	ə'tætʃ	缚， 系， 贴； 附加； 使依恋， 使喜爱； 使附属； 认为有
distribute	dɪ'strɪbjuːt; 'dɪstrɪbjuːt	dɪ'strɪbjut	分发， 分送； 分布
ankle	'æŋkl	'æŋkl	踝， 踝关节
convict	kən'vɪkt	kən'vɪkt	证明…有罪， 宣判…有罪 / 囚犯
legislation	ˌledʒɪs'leɪʃn	,lɛdʒɪs'leʃən	法律， 法规； 立法， 法律的制定
clause	klɔːz	klɔz	条款； 从句， 分句
quiz	kwɪz	kwɪz	智力竞赛，问答比赛；小测验 / 考查， 盘问
participate	pɑː'tɪsɪpeɪt	pɑr'tɪsə'pet	参与， 参加； 分享
ingredient	ɪn'griːdiənt	ɪn'ɡridɪənt	组成部分， 成分； 原料； 要素， 因素
surplus	'sɜːpləs	'sɝpləs	过剩的， 多余的 / 过剩，剩余，盈余
correspondence	ˌkɒrə'spɒndəns	,kɔrə'spɑndəns	信件， 函件； 通信， 通信联系； 符合， 一致， 相似
refresh	rɪ'freʃ	ri'frɛʃ	振作精神， 恢复活力
librarian	laɪ'breəriən	laɪ'brɛrɪən	图书馆管理员
intimate	'ɪntɪmət	ˈɪntəmɪt	亲密的；个人的 / 至交， 密友 / 暗示， 提示
reporter	rɪ'pɔːtə	rɪ'pɔrtɚ	记者
declaration	ˌdeklə'reɪʃn	,dɛklə'reʃən	宣布， 宣告； 宣言， 声明； 申报
disclose	dɪs'kləuz	dɪs'kloz	揭示； 透露
religion	rɪ'lɪdʒən	rɪ'lɪdʒən	宗教， 宗教信仰
diagram	'daɪəgræm	'daɪəɡræm	图解， 图表， 简图
claw	klɔː	klɔ	抓， 撕 / 爪，脚爪，螯
torture	'tɔːtʃə	'tɔrtʃɚ	拷问；折磨 / 拷打
prayer	preə	prɛr	祷告， 祈祷； 祷文； 祈求， 祈望
tragedy	'trædʒədi	'trædʒədi	悲剧， 惨事， 惨案； 悲剧艺术
charm	tʃɑːm	tʃɑrm	迷人的特性，魅力；符咒，咒文 / 吸引， 迷住
clap	klæp	klæp	拍手，轻拍 / 拍手， 鼓掌
purple	'pɜːpl	'pɝpl	紫的 / 紫色
quit	kwɪt	kwɪt	停止， 放弃； 离开， 辞
economical	ˌiːkə'nɒmɪkl	,ɛkə'nɑmɪkl	节约的； 经济学的
prosperous	'prɒspərəs	'prɑspərəs	繁荣的， 兴旺的
polish	'pɒlɪʃ	'pɑlɪʃ	磨光；修改，润色，使优美 / 擦光剂
cabinet	'kæbɪnət	'kæbɪnət	橱， 柜； 内阁
chart	tʃɑːt	tʃɑrt	图表；航海图 / 用图表表示， 在图上表示
optical	'ɒptɪkl	'ɑptɪkl	眼的， 光学的， 视觉的
fashion	'fæʃn	'fæʃən	样子， 方式； 时尚； 流行款式
insurance	ɪn'ʃuərəns	ɪn'ʃʊrəns	保险， 保险费
preface	'prefəs	ˈpref.ɪs	序言， 前言， 引言
principle	'prɪnsəpl	'prɪnsəpl	原则， 原理， 道义； 基本信念， 信条
lid	lɪd	lɪd	盖子， 盖
tedious	'tiːdiəs	'tidɪəs	冗长乏味的， 沉闷的
source	sɔːs	sɔrs	河的源头， 根源； 来源， 出处
secure	sɪ'kjuə	sə'kjʊr	安全的，可靠的；牢固的，稳固的；无忧虑的，安心的 / 得到， 获得； 使安全， 保卫； 缚牢
domestic	də'mestɪk	də'mɛstɪk	本国的； 家庭的； 驯养的
deception	dɪ'sepʃn	dɪ'sɛpʃən	欺骗； 诡计， 骗局
basically	'beɪsɪkli	'besɪkli	基本上， 从根本上说
donation	dəu'neɪʃn	do'neʃən	捐款， 捐赠物； 捐赠， 赠送
avenue	'ævənjuː	'ævənu	林荫道， 道路， 大街
immense	ɪ'mens	ɪ'mɛns	巨大的； 极好的
budget	'bʌdʒɪt	'bʌdʒɪt	规划，安排；编预算 / 低廉的， 收费公道的 / 预算，预算拨款
given	'gɪvn	'ɡɪvn	规定的，特定的；假设的；已知的；有癖好的，有倾向的 / 考虑到
hay	heɪ		干草
chest	tʃest	tʃɛst	胸腔， 胸膛； 箱子
tension	'tenʃn	'tɛnʃən	紧张， 不安； 拉紧； 张力， 拉力
definite	'defɪnət	'dɛfɪnət	明确的， 肯定的
reflection	rɪ'flekʃn	rɪ'flɛkʃən	映像， 倒影； 反射； 反映， 表达； 非议； 沉思， 反省
ultimate	'ʌltɪmət	ˈʌltəmɪt	最后的，最终的 / 终极， 顶点
campus	'kæmpəs	'kæmpəs	校园， 学校场地
adapt	ə'dæpt	ə'dæpt	使适应； 改编
solicitor	sə'lɪsɪtə	sə'lɪsɪtɚ	律师， 法律顾问
cheerful	'tʃɪəfl	'tʃɪrfl	快乐的， 愉快的； 使人感到愉快的
merit	'merɪt	'mɛrɪt	长处，优点，价值；功劳，成绩 / 值得， 应受
misunderstand	ˌmɪsʌndə'stænd	,mɪsʌndɚ'stænd	误解， 误会
guilty	'gɪlti	'ɡɪlti	内疚的； 有罪的
measure	'meʒə	'mɛʒɚ	测量，度量；衡量 / 分量； 尺寸； 量具； 计量单位； 量度， 测量； 措施， 办法
overall	ˌəuvər'ɔːl	,ovə'rɔl	全面的， 总体的， 全部的
receipt	rɪ'siːt	rɪ'sit	发票， 收据； 收入， 进款； 收到， 接到
assume	ə'sjuːm	ə'sum	假定， 假设， 臆断； 承担， 担任； 呈现
pepper	'pepə	'pɛpɚ	胡椒，胡椒粉 / 在…上撒； 使布满
plural	'pluərəl	'plʊrəl	复数的 / 复数
doctoral	'dɒktərəl	'dɔktərəl	博士的
concept	'kɒnsept	'kɑnsɛpt	概念， 观念， 设想
resistant	rɪ'zɪstənt	rɪ'zɪstənt	抵抗的， 抗…的， 耐…的
effort	'efət	'ɛfɚt	努力， 努力的成果
video	'vɪdiəu	'vɪdɪo	录像的；电视的 / 录像
disaster	dɪ'zɑːstə	dɪ'zæstɚ	灾难， 灾祸， 天灾； 彻底的失败
agriculture	'ægrɪkʌltʃə	'æɡrɪkʌltʃɚ	农业， 农学
weapon	'wepən	'wɛpən	武器， 兵器
grocer	'grəusə	ɡrosɚ	食品商， 杂货商
stare	steə	stɛr	盯， 凝视
painful	'peɪnfl	'penfl	疼痛的， 引起疼痛的； 困难的； 令人不快的
vote	vəut	vot; voʊt	投票； 表决 / 票，选票；选举，投票，表决；表决结果，投票总数
steady	'stedi	'stɛdi	稳定 / 稳的，平稳的；稳定的，持续的；稳固的
enhance	ɪn'hɑːns	ɪn'hæns	提高， 增加， 加强
enclose	ɪn'kləuz	ɪn'kloz	围住， 圈起； 附上； 把…装入信封
convention	kən'venʃn	kən'vɛnʃən	习俗， 惯例； 公约； 会议
disease	dɪ'ziːz	dɪ'ziz	病， 疾病； 不健全； 弊端
center	'sentə	'sɛntɚ	圆心， 正中； 中心
suspicion	sə'spɪʃn	sə'spɪʃən	怀疑， 疑心， 猜疑； 一点儿， 少量
purchase	'pɜːtʃəs	'pɝtʃəs	买，购买 / 购买； 购买的物品
refusal	rɪ'fjuːzl	rɪ'fjuzl	拒绝
technician	tek'nɪʃn	tɛk'nɪʃən	技术员， 技师
generic	dʒə'nerɪk	dʒə'nɛrɪk	【生物】 属的， 类的； 一般的， 普通的
genius	'dʒiːniəs	'dʒinjəs	天才， 天赋， 天资； 天才人物
alike	ə'laɪk	ə'laɪk	一样地， 相似地； 同样程度地 / 同样的，相同的
fund	fʌnd	fʌnd	资金，基金；存款 / 为…提供资金
gravity	'grævəti	ˈɡrævətɪ	重力， 引力； 严重性； 严肃， 庄重
typical	'tɪpɪkl	'tɪpɪkl	典型的， 代表性的
quotation	kwəu'teɪʃn	kwo'teʃən	引文， 引语， 语录； 报价， 牌价， 行情
finance	faɪ'næns; fə'næns	'faɪnæns	筹措资金 / 财政，金融；财源，财务情况
studio	'stjuːdiəu	'studɪo	画室， 摄影室； 播音室， 录音室， 摄影棚
tray	treɪ	tre	盘， 托盘， 碟
downward	'daunwəd	'daʊnwɚd	向下地 / 向下的
cabbage	'kæbɪdʒ	ˈkæbɪdʒ	洋白菜， 卷心菜
regulate	'regjuleɪt	'rɛɡjulet	管理， 控制； 调整， 调节
palm	pɑːm	pɑm	手掌， 掌状物； 棕榈树
hydrogen	'haɪdrədʒən	'haɪdrədʒən	氢
infant	'ɪnfənt	'ɪnfənt	婴儿的； 幼稚的 / 婴儿
hen	hen	hɛn	母鸡， 雌禽
whoever	huː'evə	hʊ'ɛvɚ	谁； 无论谁； 究竟是谁
carbon	'kɑːbən	'kɑrbən	碳
unload	ˌʌn'ləud	'ʌn'lod	卸， 卸货； 下客； 退出子弹； 卸下胶卷
payment	'peɪmənt	'pemənt	支付， 支付的款项
specifically	spə'sɪfɪkli	spə'sɪfɪkli	特别地， 特定地； 明确地， 具体地
controversial	ˌkɒntrə'vɜːʃl	,kɑntrə'vɝʃl	引起争论的， 有争议的
attain	ə'teɪn	ə'ten	达到， 获得， 完成
trap	træp	træp	陷阱，捕捉器；圈套，诡计；困境 / 设陷阱捕捉； 诱骗
gallery	'gæləri	'gæləri	画廊， 美术馆； 楼座； 旁听席； 回廊， 走廊
hardware	'hɑːdweə	'hɑrdwɛr	五金器具； 硬件
deputy	'depjuti	'dɛpjuti	副职， 副手； 代表， 代理人
warmth	wɔːmθ	wɔrmθ	暖和， 温暖； 热烈， 热情， 热心
supreme	suː'priːm	suˈprim	最高的， 最大的； 极度的， 最重要的
ambulance	'æmbjələns	'æmbjələns	救护车； 野战医院
priority	praɪ'ɒrəti	praɪ'ɔrəti	优先， 重点； 优先考虑的事
slope	sləup	slop	倾斜 / 倾斜；斜面
philosophy	fə'lɒsəfi	fə'lɑsəfi	哲学， 哲理， 人生哲学
preventive	prɪ'ventɪv	pri'vɛntɪv	预防性的
creative	kri'eɪtɪv	krɪ'etɪv	创造性的， 创作的
junior	'dʒuːniə	'dʒunɪɚ	年少的；资历较浅的 / 晚辈； 三年级学生
allocate	'æləkeɪt	'æləket	分配， 分派， 把…拨给
provide	prə'vaɪd	prə'vaɪd	提供， 供给
standpoint	'stændpɔɪnt	'stændpɔɪnt	立场， 观点
worship	'wɜːʃɪp	'wɝʃɪp	礼拜；崇拜；信奉 / 崇拜
lawn	lɔːn	lɔn	草地， 草坪， 草场
primary	'praɪməri	'praɪmɛri	首要的， 主要的； 基本的； 最初的， 初级的
log	lɒg	lɔɡ	原木，木料；航海日志 / 正式记录
solar	'səulə	'solɚ	太阳的， 日光的； 太阳能的
consume	kən'sjuːm	kənˈsum	消费， 吃完， 喝光； 毁灭； 使着迷， 充满
formation	fɔː'meɪʃn	fɔr'meʃən	形成， 构成， 形成物； 队形， 排列
layer	'leɪə	'leɪr	层， 层次
triangle	'traɪæŋgl	'traɪæŋɡl	三角
accidental	ˌæksɪ'dentl	,æksɪ'dɛntl	偶然的， 意外的
assure	ə'ʃuə	ə'ʃʊr	使确信； 确保， 向…保证
consult	kən'sʌlt	kən'sʌlt	请教； 查阅； 商议
theme	θiːm	θim	主题， 题目
smash	smæʃ	smæʃ	粉碎，打烂；狠打，猛击；破灭，失败；猛撞，猛冲 / 破碎 ； 猛击， 猛撞； 轰动的演出， 巨大的成功
merely	'mɪəli	'mɪrli	仅仅， 只不过
contradiction	ˌkɒntrə'dɪkʃn	,kɑntrə'dɪkʃən	矛盾， 不一致； 否认， 反驳
fuss	fʌs	fʌs	忙乱； 大惊小怪， 小题大做； 烦恼， 过于忧虑
wealth	welθ	wɛlθ	财富， 财产； 丰富
editor	'edɪtə	'ɛdɪtɚ	编辑， 编者， 校订者
barrel	'bærəl	'bærəl	桶； 圆筒； 枪管
means	miːnz	minz	方法， 手段， 工具； 金钱， 财产
desire	dɪ'zaɪə	dɪ'zaɪɚ	渴望；要求 / 愿望； 欲望
survive	sə'vaɪv	sɚ'vaɪv	活下来， 幸存 / 从…逃出，幸免于；从中挺过来；比…活得长
efficient	ɪ'fɪʃnt	ɪ'fɪʃnt	效率高的； 有能力的
initial	ɪ'nɪʃl	ɪ'nɪʃəl	最初的，开始的 / 首字母
unfortunately	ʌn'fɔːtʃənətli	ʌn'fɔrtʃənətli	不幸地
consistent	kən'sɪstənt	kən'sɪstənt	坚持的， 一贯的； 一致的， 符合的
reverse	rɪ'vɜːs	rɪ'vɝs	撤销，推翻；反向，倒转；彻底改变 / 反向的， 相反的， 倒转的 / 相反，对立面；反面，背面，后面；挫折，逆境
heterogeneity	ˌhetərədʒə'niːəti	,hetərəudʒi'ni:əti	异种， 异质， 不同成分
sword	sɔːd	sɔːrd	剑， 刀
permanent	'pɜːmənənt	'pɝmənənt	永久的， 固定的
barely	'beəli	'bɛrli	仅仅， 只不过， 几乎不
summarize	'sʌməraɪz	'sʌməraɪz	概括， 概述， 总结
chap	tʃæp	tʃæp	小伙子， 男人， 家伙
facility	fə'sɪləti	fə'sɪləti	设备； 容易； 场所
beam	biːm	bim	梁，横梁；束，柱；笑容，喜色 / 面露喜色； 定向发出， 播送
alliance	ə'laɪəns	ə'laɪəns	结盟， 联盟
civilization	ˌsɪvəlaɪ'zeɪʃn	,sɪvələ'zeʃən	文明， 文化； 开化
fiction	'fɪkʃn	'fɪkʃən	小说； 虚构， 杜撰
possession	pə'zeʃn	pə'zɛʃən	有， 所有； 所有物
replace	rɪ'pleɪs	rɪ'ples	代替， 取代； 更换， 调换； 把…放回原处
appointment	ə'pɔɪntmənt	ə'pɔɪntmənt	任命； 约定； 约会； 委任的职位
hip	hɪp	hɪp	臀部， 髋部
merry	'meri	'mɛri	欢乐的， 愉快的
dam	dæm	dæm	水坝，水堤；障碍物 / 筑堤挡住
pessimistic	ˌpesɪ'mɪstɪk	,pɛsɪ'mɪstɪk	悲观的
commander	kə'mɑːndə	kə'mændɚ	司令官， 指挥员
bloom	bluːm	blum	开花 / 花，开花，开花期；青春焕发
major	'meɪdʒə	'medʒɚ	较大的；主要的；重大的 / 少校； 专业
zone	zəun	zon	地区， 区域， 范围
emphasis	'emfəsɪs	'ɛmfəsɪs	强调； 重点， 重要性
interrupt	ˌɪntə'rʌpt	'ɪntə'rʌpt	打断， 打扰， 中断
feasible	'fiːzəbl	'fizəbl	可行的， 可能的
prescribe	prɪ'skraɪb	prɪ'skraɪb	开； 吩咐采用； 规定， 指定
potential	pə'tenʃl	pə'tɛnʃl	潜在的，可能的 / 潜力， 潜能
bean	biːn	bin	豆， 蚕豆
accustomed	ə'kʌstəmd	ə'kʌstəmd	惯常的， 习惯的
combination	ˌkɒmbɪ'neɪʃn	,kɑmbɪ'neʃən	结合， 联合； 化合
obtain	əb'teɪn	əb'ten	获得； 通用， 流行； 存在
turbine	'tɜːbaɪn	'tɝbaɪn	叶轮机， 汽轮机
repeatedly	rɪ'piːtɪdli	rɪ'pitɪdli	一再， 再三， 多次地
curiosity	ˌkjuəri'ɒsəti	,kjʊrɪ'ɑsəti	好奇， 好奇心； 奇物， 奇事， 珍品
gross	grəus	ɡros	总的； 严重的； 粗俗的； 臃肿的
workshop	'wɜːkʃɒp	'wɝkʃɑp	车间， 作坊， 创作室； 研讨会， 讲习班
resist	rɪ'zɪst	rɪ'zɪst	抵抗， 反抗， 抵制； 抗， 耐； 忍住， 拒受…的影响
liter	'liːtə	litɚ	升
format	'fɔːmæt	'fɔrmæt	设计，安排；格式，样式，版式 / 使格式化
sacrifice	'sækrɪfaɪs	'sækrɪfaɪs	牺牲，舍身；献祭，供奉 / 牺牲； 供奉； 祭品
illegal	ɪ'liːgl	ɪ'ligl	不合法的， 非法的
stimulate	'stɪmjuleɪt	'stɪmjə'let	刺激， 激励， 激发
formal	'fɔːml	'fɔrml	正式的， 礼仪上的
congratulate	kən'grætʃuleɪt	kən'ɡrætʃulet	祝贺， 向…道喜
rainbow	'reɪnbəu	'renbo	虹， 彩虹
soak	səuk	sok	浸， 泡
soar	sɔː	sɔr	猛增， 剧增； 高飞， 升腾； 高涨； 高耸， 屹立
salesman	'seɪlzmən	'selzmən	售货员， 推销员
interference	ˌɪntə'fɪərəns	,ɪntɚ'fɪrəns	干涉， 干预， 阻碍
fibre	'faɪbə	'faibə	纤维， 纤维质
sustain	sə'steɪn	sə'sten	保持， 使持续下去； 供养， 维持； 支持， 支撑； 经受， 遭受
entertain	ˌentə'teɪn	,ɛntɚ'ten	使欢乐； 招待， 请客
altitude	'æltɪtjuːd	'æltɪtud	海拔， 高度； 高处
classify	'klæsɪfaɪ	'klæsɪfaɪ	把…分类， 把…分级
ease	iːz	iz	容易；舒适 / 缓和
critical	'krɪtɪkl	'krɪtɪkl	决定性的； 批评的
colony	'kɒləni	'kɑləni	殖民地； 侨居地， 聚居地； 群体， 集群
mathematics	ˌmæθə'mætɪks	,mæθə'mætɪks	数学
wagon	'wægən	'wægən	四轮马车， 大篷车； 铁路货车， 客货两用车
elsewhere	ˌels'weə	,els'hwεə	在别处， 向别处
penetrate	'penɪtreɪt	'pɛnətret	透入， 渗入， 进入； 刺穿； 洞察， 了解
principal	'prɪnsəpl	'prɪnsəpl	最重要的，主要的 / 负责人， 校长； 资本， 本金； 主要演员， 主角
tend	tend	tɛnd	照管， 照料， 护理 / 易于，往往会；趋向，倾向
exceedingly	ɪk'siːdɪŋli	ɪk'sidɪŋli	极端地， 非常
specimen	'spesɪmən	'spɛsəmən	样本， 标本， 样品
relief	rɪ'liːf	rɪ'lif	轻松， 宽慰； 缓解； 调剂， 消遣； 接替
dimension	dɪ'menʃn; daɪ'menʃn	dəˈmɛnʃən, daɪ-	尺寸， 尺度； 方面， 特点； 面积， 规模
introduction	ˌɪntrə'dʌkʃn	,ɪntrə'dʌkʃən	介绍， 引进； 引言
deserve	dɪ'zɜːv	dɪ'zɝv	应受， 值得
process	'prəuses	proˈsɛs;(for n.)prɑsɛs	过程；制作法；程序 / 加工； 办理
philosopher	fə'lɒsəfə	fə'lɑsəfɚ	哲学家， 哲人
restore	rɪ'stɔː	rɪ'stɔr	恢复， 使回复； 修复， 整修； 归还， 交还
therapy	'θerəpi	'θɛrəpi	治疗， 理疗
alternative	ɔːl'tɜːnətɪv	ɔl'tɝnətɪv	两者选一的， 供选择的； 另类的 / 替换物，选择；选择的自由
banner	'bænə	'bænɚ	横幅； 旗， 旗帜
concentration	ˌkɒnsn'treɪʃn	'kɑnsn'treʃən	集中； 专注， 专心； 浓缩， 浓度
encounter	ɪn'kauntə	ɪn'kaʊntɚ	遭遇，遇到 / 遭遇
soda	'səudə	'sodə	碳酸钠， 纯碱； 汽水， 苏打水
colleague	'kɒliːg	'kɑliɡ	同事， 同僚
gratitude	'grætɪtjuːd	'ɡrætɪtud	感激， 感谢， 感恩
approve	ə'pruːv	ə'prʊv	赞成， 称许； 批准
interaction	ˌɪntər'ækʃn	,ɪntə'rækʃən	相互作用， 干扰
chew	tʃuː	tʃʊ	咀嚼， 嚼碎
interfere	ˌɪntə'fɪə	,ɪntɚ'fɪr	干涉， 干预， 妨碍
apartment	ə'pɑːtmənt	ə'pɑrtmənt	一套公寓房间
account	ə'kaunt	ə'kaʊnt	说明原因； 占 / 记述；解释；账目
uneasy	ʌn'iːzi	ʌn'izi	心神不安的， 忧虑的
tolerate	'tɒləreɪt	'tɑləret	忍受， 容忍； 容许， 承认
developmental	dɪˌveləp'mentl	dɪ,vɛləp'mɛntl	发展的
stack	stæk	stæk	堆，垛 / 堆积， 堆放于
underline	ˌʌndə'laɪn	'ʌndəlaɪn	在…下面画线； 强调， 使…突出
innocent	'ɪnəsnt	'ɪnəsnt	清白的； 幼稚的； 没有恶意的
compassion	kəm'pæʃn	kəm'pæʃən	同情， 怜悯
alphabet	'ælfəb3t	'ælfə'bɛt	字母表， 字母系统
parliament	'pɑːləmənt	'pɑrləmənt	议会， 国会
evaluation	ɪˌvælju'eɪʃn	ɪ,væljʊ'eʃən	评价； 估计
crack	kræk	kræk	爆裂； 噼啪地响； 打， 击 / 裂缝，裂纹；破裂声
bind	baɪnd	baɪnd	捆绑， 包扎； 装订； 约束； 使结合， 使黏合
trim	trɪm	trɪm	整齐的 / 使整齐
appreciate	ə'priːʃieɪt	ə'priʃɪet	重视， 赏识； 领会， 体会； 感谢； 增值
dental	'dentl	'dɛntl	牙齿的， 牙科的
predictable	prɪ'dɪktəbl	prɪ'dɪktəbl	可预料的
diverse	daɪ'vɜːs	daɪ'vɝs	不一样的， 相异的； 多种多样的
railway	'reɪlweɪ	'relwe	铁路
cube	kjuːb	kjʊb	清澈透明的 / 立方形，立方
rally	'ræli	'ræli	集合， 团结； 恢复， 重新振作 / 集会；公路汽车赛
prime	praɪm	praɪm	首要的；最好的 / 青春；全盛时期 / 使准备好
happen	'hæpən	'hæpən	发生； 碰巧， 恰好
festival	'festɪvl	ˈfɛstəvl	节日； 音乐节
mild	maɪld	maɪld	温柔的； 温暖的； 轻微的
profile	'prəufaɪl	'profaɪl	侧面；人物简介；轮廓，形象；姿态，引人注目的状态 / 为…描绘； 写…的传略
loyal	'lɔɪəl	'lɔɪəl	忠诚的， 忠心的
preference	'prefrəns	'prɛfrəns	喜爱， 偏爱； 偏爱的事物； 优先
impact	'ɪmpækt	ɪm'pækt	影响， 作用， 冲击
opportunity	ˌɒpə'tjuːnəti	ˌɑpɚˈtunətɪ	机会， 良机
active	'æktɪv	'æktɪv	活跃的， 积极的； 主动的； 起作用的
dorm	dɔːm	dɔrm	宿舍
whichever	wɪtʃ'evə	wɪtʃ'ɛvɚ	无论哪个， 无论哪些
court	kɔːt	kɔrt	法院， 法庭； 庭院； 宫廷； 球场
venture	'ventʃə	'vɛntʃɚ	冒险， 敢于 / 风险投资，风险项目
mill	mɪl	mil	磨， 碾 / 磨坊；碾磨机；制造厂，工厂
bucket	'bʌkɪt	'bʌkɪt	水桶， 吊桶； 铲斗
senior	'siːniə	'sinɪɚ	资格较老的，地位较高的；年长的 / 较年长者； 毕业班学生
dose	dəus	dos	剂量， 用量， 一剂
route	ruːt	raʊt	路线， 路程
enthusiasm	ɪn'θjuːziæzəm	ɪn'θuzɪæzəm	热情， 热心， 热忱； 巨大兴趣
flexible	'fleksəbl	'flɛksəbl	易弯曲的， 灵活的
adult	'ædʌlt; ə'dʌlt	'ædʌlt	成年的； 成年人的， 适宜于成年人的 / 成年人
attitude	'ætɪtjuːd	'ætɪtʊd	态度， 看法； 姿势
relative	'relətɪv	'rɛlətɪv	有关系的，相对的 / 亲属， 亲戚
organ	'ɔːgən	'ɔrɡən	器官； 机构； 管风琴； 新闻媒介
average	'ævərɪdʒ	'ævərɪdʒ	平均的；平常的 / 平均 / 平均数，平均
treatment	'triːtmənt	'tritmənt	待遇； 治疗， 疗法； 对待， 处理
compare	kəm'peə	kəm'pɛr	比较， 对照； 把…比作
pluralism	'pluərəlɪzəm	'plʊər(ə)lɪz(ə)m	多重性； 兼职， 兼任
influential	ˌɪnflu'enʃl	,ɪnflu'ɛnʃl	有影响的； 有权势的
shiver	'ʃɪvə	'ʃɪvɚ	战栗， 颤抖
Bible	'baɪbl	'baɪbl	圣经
liquor	'lɪkə	'lɪkɚ	酒， 烈性酒
honourable	'ɒnərəbl	'ɔnərəbl	光荣的； 可敬的； 正直的
characteristic	ˌkærəktə'rɪstɪk	,kærəktə'rɪstɪk	特有的，典型的 / 特性
transparent	træns'pærənt	træns'pærənt	透明的； 易识破的； 明显的， 清楚的
interior	ɪn'tɪəriə	ɪn'tɪrɪɚ	内部的；内地的 / 内部
rouse	rauz	raʊz	惊起； 唤起； 唤醒
journal	'dʒɜːnl	'dʒɝnl	日报， 杂志， 日志
grasp	grɑːsp	ɡræsp	抓紧，握紧；理解 / 抓； 理解
involvement	ɪn'vɒlvmənt	ɪn'vɔlvmənt	连累； 包含
spark	spɑːk	spɑrk	发出火花 / 火花，火星
unlike	ˌʌn'laɪk	'ʌn'laɪk	不同的 / 不像…
assembly	ə'sembli	ə'sɛmbli	立法机构； 议会； 集合； 集会的人们； 装配， 组装
hearing	'hɪərɪŋ	'hɪrɪŋ	听力， 听觉； 听力所及之距离； 意见听取会； 申辩的机会
acquisition	ˌækwɪ'zɪʃn	,ækwɪ'zɪʃən	取得， 获得， 习得； 获得物， 增添的人
volcano	vɒl'keɪnəu	vɑl'keno	火山
rigid	'rɪdʒɪd	'rɪdʒɪd	严格的； 死板的； 刚硬的， 僵硬的
deadline	'dedlaɪn	ˈdedlaɪn	最后期限
so-called	ˌsəu'kɔːld	,so'kɔld	所谓的， 号称的
grateful	'greɪtful	'ɡretfl	感激的； 令人愉快的
chip	tʃɪp	tʃɪp	屑片， 碎片； 炸土豆条； 集成电路片， 集成块； 缺口， 瑕疵
chin	tʃɪn	tʃɪn	颏， 下巴
emotional	ɪ'məuʃənl	ɪ'moʃənl	感情的， 情绪的
operational	ˌɒpə'reɪʃənl	'ɑpə'reʃənl	运转的； 可使用的； 操作上的
staff	stɑːf	stæf	工作人员；参谋 / 为…配备人员
involve	ɪn'vɒlv	ɪn'vɑlv	使卷入， 牵涉； 包含， 含有
noticeable	'nəutɪsəbl	'notɪsəbl	显而易见的
assemble	ə'sembl	ə'sɛmbl	集合， 召集； 装配
blast	blɑːst	blæst	爆炸，冲击波；一阵 / 炸
series	'sɪəriːz	'sɪriz	一系列， 连续； 丛书， 连续剧
complicated	'kɒmplɪkeɪtɪd	'kɑmplɪketɪd	复杂的， 难懂的
cultivate	'kʌltɪveɪt	'kʌltɪvet	耕作， 种植； 培养， 陶冶
maximum	'mæksɪməm	ˈmæksəməm	最大的， 最高的， 顶点的 / 最大量，顶点
thrive	θraɪv	θraɪv	兴旺， 繁荣， 旺盛
purse	pɜːs	pɝs	钱包， 女用小提包
represent	ˌreprɪ'zent	,rɛprɪ'zɛnt	作为…的代表； 表示， 象征； 描绘， 表现
compete	kəm'piːt	kəm'pit	比赛， 竞争， 对抗
dialect	'daɪəlekt	'daɪə'lɛkt	方言， 土语， 地方话
accountant	ə'kauntənt	ə'kaʊntənt	会计人员， 会计师
stocking	'stɒkɪŋ	'stɑkɪŋ	长袜
dim	dɪm	dɪm	昏暗的；朦胧的；模糊不清的 / 变暗淡
emergency	i'mɜːdʒənsi	ɪ'mɝdʒənsi	紧急情况， 突然事件
dip	dɪp	dɪp	蘸，浸 / 游一会儿泳
recreational	ˌrekri'eɪʃənl	,rɛkri'eʃənəl	休养的； 娱乐的
faculty	'fæklti	'fæklti	才能， 能力； 系， 科； 全体教员
trail	treɪl	trel	痕迹，小径 / 跟踪， 追踪
passport	'pɑːspɔːt	'pæspɔrt	护照
prior	'praɪə	'praɪɚ	在前的； 优先的
considerate	kən'sɪdərət	kənˈsɪdərɪt	考虑周到的， 体贴的， 体谅的
clue	kluː	klʊ	线索， 暗示， 提示
legal	'liːgl	'ligl	法律的； 合法的
bracket	'brækɪt	'brækɪt	括号 / 把…归为同一类
highway	'haɪweɪ	'haɪwe	公路， 大路
vanish	'vænɪʃ	'vænɪʃ	突然不见， 消失； 不复存在， 绝迹
signal	'sɪgnəl	'sɪgnl	显著的， 重大的 / 信号，暗号；标志，表示 / 发信号；标志着
sightseeing	'saɪtsiːɪŋ	'saɪtsiɪŋ	观光， 游览
parcel	'pɑːsl	'pɑrsl	包裹，小包，邮包 / 分， 分配； 把…包起来， 捆扎
static	'stætɪk	'stætɪk	静的，静态的；静止的，停滞的 / 静电
journey	'dʒɜːni	ˈdʒɝ​nɪ	旅行 / 旅行，旅程
planet	'plænɪt	'plænɪt	行星
finally	'faɪnəli	'faɪnlɪ	最后； 决定性地
exhaust	ɪg'zɔːst	ɪɡ'zɔst	使筋疲力尽；用尽；详尽论述 / 排气装置； 废气
creep	kriːp	krip	爬行， 缓慢地行进
strap	stræp	stræp	带子 / 捆扎； 用绷带包扎
grape	greɪp	ɡrep	葡萄， 葡萄藤
conviction	kən'vɪkʃn	kən'vɪkʃən	确信； 坚定的信仰； 说服， 信服； 定罪， 判罪
scholar	'skɒlə	'skɑlɚ	学者； 奖学金获得者
straw	strɔː	strɔ	稻草； 麦秆吸管， 吸管
regarding	rɪ'gɑːdɪŋ	rɪ'ɡɑrdɪŋ	关于
graph	græf	ɡræf	图， 图表
vision	'vɪʒn	'vɪʒən	想象力； 梦幻； 视力， 视觉
accompany	ə'kʌmpəni	ə'kʌmpəni	陪伴， 陪同， 伴随； 为…伴奏
petrol	'petrəl	'pɛtrəl	汽油
acceptance	ək'septəns	ək'sɛptəns	接受； 承认； 容忍
relativity	ˌrelə'tɪvəti	,rɛlə'tɪvəti	相对论； 相关性
beneficial	ˌbenɪ'fɪʃl	,bɛnɪ'fɪʃl	有利的， 有益的
tackle	'tækl	'tækl	对付，处理；与…交涉；阻截，擒抱 / 阻截， 擒抱； 用具， 钓具； 辘轳， 滑车
reckon	'rekən	'rɛkən	认为， 估计； 指望， 盼望； 测算， 测量
confusion	kən'fjuːʒn	kən'fjʊʒən	困惑， 糊涂； 混淆； 骚乱
occasion	ə'keɪʒn	ə'keʒn	场合，时刻；重大活动；时机；起因 / 引起
loan	ləun	lon	贷款， 借
virtual	'vɜːtʃuəl	ˈvɝ​tʃʊəl	实质上的， 事实上的， 实际上的
squeeze	skwiːz	skwiz	挤；压榨，榨取；捏，握 / 挤； 握手； 拮据， 紧缺
blank	blæŋk	blæŋk	空白的；茫然的，无表情的 / 空白； 空白表格
landlord	'lændlɔːd	'lændlɔrd	地主， 房东； 店主
session	'seʃn	'sɛʃən	会议， 一届会期； 集会
additional	ə'dɪʃənl	ə'dɪʃənl	附加的， 追加的
worthy	'wɜːði	wɜði	有价值的， 值得的
endless	'endləs	ˈɛndlɪs	无止境的
expectation	ˌekspek'teɪʃn	,ɛkspɛk'teʃən	期待， 期望， 预期； 前程， 成功的前景
title	'taɪtl	'taɪtl	标题， 题目； 称号， 头衔； 权利， 权益
mist	mɪst	mɪst	蒙上薄雾； 模糊 / 薄雾
primarily	'praɪmərəli; praɪ'merəli	praɪ'mɛrəli	首先； 主要地
duration	dju'reɪʃn	du'reʃən	持续， 持久
plantation	plɑːn'teɪʃn	plæn'teʃən	种植园， 人工林
ignore	ɪg'nɔː	ɪɡ'nɔr	不顾， 不理， 忽视
loaf	ləuf	lof	游荡， 闲逛 / 面包
nuclear	'njuːkliə	'nuklɪɚ	核子的， 核能的， 核武器的； 核心的
reception	rɪ'sepʃn	rɪ'sɛpʃən	招待会， 欢迎会； 接受； 接待； 接收效果
outward	'autwəd	'aʊtwɚd	外面的； 外表的； 向外的
bloody	'blʌdi	'blʌdi	[用于加强语气]非常，很 / [用于加强语气]非常的；该死的；流血的；嗜杀的 / 血染
poetry	'pəuətri	'poətri	诗， 诗歌， 诗集
owner	'əunə	'onɚ	物主， 所有人
vapour	'veɪpə	'vepɚ	蒸汽
sole	səul	sol	单独的， 唯一的 / 脚底，鞋底，袜底
jury	'dʒuəri	'dʒʊri	陪审团； 评奖团
holy	'həuli	'holi	神圣的， 圣洁的， 虔诚的
spelling	'spelɪŋ	'spɛlɪŋ	拼字， 拼法， 拼写法
relax	rɪ'læks	rɪ'læks	放松， 松弛； 放宽， 缓和
priest	priːst	prist	神父， 牧师
monitor	'mɒnɪtə	'mɔnɪtɚ	班长；监视器，检测器；显示器 / 监听； 检测
permission	pə'mɪʃn	pɚ'mɪʃən	允许， 许可， 准许
grand	grænd	ɡrænd	宏伟的； 重大的； 傲慢的； 派头大的； 绝佳的； 全部的
schedule	'ʃedjuːl	ˈskedʒʊl; skɛdʒʊl	时刻表，日程安排表；清单，明细表 / 安排， 排定
postage	'pəustɪdʒ	'postɪdʒ	邮费， 邮资
tame	teɪm	teɪm	驯服的，顺从的；沉闷的，乏味的 / 制服， 控制并利用； 驯化， 驯服
material	mə'tɪəriəl	mə'tɪrɪəl	物质的， 实体的； 肉体的； 重要的， 实质性的 / 材料，素材
universe	'juːnɪvɜːs	'junɪvɝs	宇宙， 世界； 领域， 范围
interpret	ɪn'tɜːprɪt	ɪn'tɝprɪt	解释， 说明； 口译
spectacular	spek'tækjələ	spɛk'tækjəlɚ	壮观的，引人注目的 / 壮观的演出； 惊人之举
inherit	ɪn'herɪt	ɪn'hɛrɪt	成为继承人 / 继承
peculiar	pɪ'kjuːliə	pɪ'kjulɪɚ	奇怪的， 古怪的； 特有的
blanket	'blæŋkɪt	'blæŋkɪt	毛毯， 毯子， 羊毛毯
grant	grɑːnt	ɡrænt	授予物；补助金 / 授予， 给予； 同意
injection	ɪn'dʒekʃn	ɪn'dʒɛkʃən	注射， 注入； 充满
envy	'envi	'ɛnvi	妒忌，羡慕；妒忌的对象 / 妒忌， 羡慕
hut	hʌt	hʌt	小屋， 棚屋
invincible	ɪn'vɪnsəbl	ɪn'vɪnsəbl	不能征服的， 无敌的
discount	'dɪskaʊnt	dɪs'kaʊnt	折扣 / 将…打折扣； 不信； 漠视， 低估
convert	kən'vɜːt	kən'vɝt	转变， 转化； 改变
construct	kən'strʌkt	kən'strʌkt	建造； 构思 / 建筑物； 构想， 观念
attempt	ə'tempt	ə'tɛmpt	尝试， 试图， 努力
thick	θɪk	θɪk	厚厚地 / 厚的，密的，浓的；不清楚的，口音重的
superficial	ˌsjuːpə'fɪʃl	,supɚ'fɪʃl	表面的， 肤浅的
division	dɪ'vɪʒn	də'vɪʒən	分， 分配； 除法； 分歧； 分裂
executive	ɪg'zekjətɪv	ɪɡ'zɛkjətɪv	执行的 / 执行者
navigation	ˌnævɪ'geɪʃn	'nævə'geʃən	航行， 航海， 航空； 导航， 领航
melt	melt	mɛlt	融化； 熔化； 消散
hook	huk	hʊk	钩住 / 钩，挂钩
stale	steɪl	stel	不新鲜的； 陈腐的， 过时的
balance	'bæləns	'bæləns	使平衡；称；权衡，比较 / 天平； 平衡； 结存， 结欠
cigar	sɪ'gɑː	sɪ'ɡɑr	雪茄烟
action	'ækʃn	'ækʃən	行动； 已做的事； 作用， 功能； 情节
stadium	'steɪdiəm	'stedɪəm	运动场， 体育场
whereas	weər'æz	'wɛr'æz	然而， 但是， 尽管
pitch	pɪtʃ	pɪtʃ	投， 掷； 架设， 搭， 营； 颠簸 / 球场；程度，强度；高度；音高；沥青 / 投掷；使猛然倒下；表达；把…定于特定程度；定调
kindness	'kaɪndnəs	'kaɪndnəs	仁慈， 好意
adoptive	ə'dɒptɪv	ə'dɑptɪv	收养关系的； 采用的
chop	tʃɒp	tʃɑp	砍，劈；切细 / 排骨
electrical	ɪ'lektrɪkl	ɪ'lɛktrɪkl	电的， 电气科学的
statue	'stætʃuː	'stætʃu	塑像， 雕像， 铸像
being	'biːɪŋ	'biɪŋ	存在； 生物， 生命
sensitive	'sensətɪv	'sɛnsətɪv	敏感的， 灵敏的， 神经过敏的； 容易生气的， 易受伤害的
protest	prəˈtest;ˈprəʊtest	prəˈtɛst;protɛst	抗议， 反对 / 抗议， 反对
classification	ˌklæsɪfɪ'keɪʃn	,klæsɪfɪ'keʃən	分类， 分级， 分类法； 类别， 级别
vacant	'veɪkənt	'vekənt	空的， 未被占用的； 空缺的； 茫然的， 空虚的
physicist	'fɪzɪsɪst	'fɪzɪsɪst	物理学家
afford	ə'fɔːd	ə'fɔrd	担负得起； 提供
underground	'ʌndəgraund	ʌndɚˈɡraʊnd	在地下，往地下；秘密地，不公开地 / 地下的；秘密的，不公开的 / 地铁； 地下组织
curse	kɜːs	kɝs	诅咒，咒骂 / 天谴； 祸害， 祸根
impression	ɪm'preʃn	ɪm'prɛʃən	印象； 印记
baseball	'beɪsbɔːl	'besbɔl	棒球
interval	'ɪntəvl	'ɪntɚvl	间隔， 间距； 幕间休息
evaluate	ɪ'væljueɪt	ɪ'væljʊ'et	评价； 估…的价
machinery	mə'ʃiːnəri	mə'ʃinəri	机器， 机械
status	'steɪtəs	ˈstetəs	地位， 身份； 情形， 状况
shield	ʃiːld	ʃild	防护物，护罩；盾 / 保护， 防护
upset	ʌp'set	ʌp'sɛt	心烦的， 苦恼的； 不适的 / 使心烦意乱，使苦恼，使不适；搅乱；弄翻，倾覆 / 翻倒；搅乱；不安；不适
inference	'ɪnfərəns	'ɪnfərəns	推断结果， 结论； 推论， 推理， 推断
curve	kɜːv	kɝv	弯曲 / 曲线，弯，弯曲处
dot	dɒt	dɑt	点，圆点 / 打点于
skim	skɪm	skɪm	撇去， 掠过， 擦过； 浏览， 略读
phenomenon	fə'nɒmɪnən	fə'nɑmɪnən	现象
notify	'nəutɪfaɪ	'notə'fai	通知， 告知， 报告
mention	'menʃn	'mɛnʃən	提及， 说起
stream	striːm	strim	流出， 涌出 / 河，溪流；一股，一串
laundry	'lɔːndri	'lɔndri	洗衣房， 洗衣店； 待洗的衣服， 洗好的衣服
accumulate	ə'kjuːmjəleɪt	ə'kjumjəlet	积累， 堆积
crime	kraɪm	kraɪm	罪， 罪行， 犯罪
heave	hiːv	hiv	起伏，隆起；呕吐，恶心 / 举起，提起，拉起，拖；扔；发出 / 举起； 起伏， 升降
leisure	'leʒə	'liʒɚ	空闲时间； 悠闲
nourish	'nʌrɪʃ	'nɜrɪʃ	提供养分， 养育
surround	sə'raund	sə'raʊnd	围， 围绕； 圈住
mat	mæt	mæt	席子， 垫子
cigarette	ˌsɪgə'ret	ˌsɪɡəˈrɛt, ˈsɪɡəˌrɛt	香烟， 纸烟， 卷烟
torch	tɔːtʃ	tɔrtʃ	火炬， 火把； 手电筒
positive	'pɔzətɪv	'pɑzətɪv	确实的， 明确的； 积极的， 肯定的
favourite	'feɪvərɪt	'fevərɪt	特别受喜爱的 / 特别受喜爱的人
menu	'menjuː	'mɛnju	菜单
prospect	'prɒspekt	'prɑspɛkt	勘探， 勘察 / 前景， 前途， 可能性； 景象， 景色； 可能成为主顾的人； 有希望的候选人
radar	'reɪdɑː	'redɑr	雷达
refugee	ˌrefju'dʒiː	'rɛfjʊdʒi	难民
aluminium	ˌæljə'mɪniəm	,æljə'mɪnɪəm	铝
comparable	'kɒmpərəbl	'kɑmpərəbl	可比较的； 类似的； 比得上的
specialize	'speʃəlaɪz	'spɛʃəlaɪz	成为…专家； 专攻
rotate	rəu'teɪt	'rotet	旋转， 转动； 轮流
instance	'ɪnstəns	'ɪnstəns	例子， 实例， 事例
opera	'ɒprə	'ɑprə	歌剧
presumably	prɪ'zjuːməbli	prɪ'zuməbli	大概， 可能， 据推测
conscience	'kɒnʃəns	ˈkɑːnʃəns	良心， 道德心
subject	ˈsʌbdʒɪkt;(for adj.)ˈsʌbdʒɪkt;(for v.)səbˈdʒekt	ˈsʌbdʒɪkt;(for adj.)ˈsʌbdʒɪkt;(for v.)səbˈdʒɛkt	题目； 学科； 主语 / 使隶属
practically	'præktɪkli	'præktɪkli	几乎， 简直； 实际上
recognition	ˌrekəg'nɪʃn	,rɛkəɡ'nɪʃən	认出， 识别； 承认； 赏识， 表彰， 报偿
cassette	kə'set	kə'sɛt	盒式录音带
blade	bleɪd	bled	刀刃， 刀片， 叶片
arrangement	ə'reɪndʒmənt	ə'rendʒmənt	整理， 排列， 安排； 准备工作
revenue	'revənjuː	'rɛvənu	收入， 收益； 税收， 岁入
strip	strɪp	strɪp	脱光衣服；剥夺，夺去 / 条带
solution	sə'ljuːʃn	sə'luʃən	解决； 解决办法； 溶液
continuous	kən'tɪnjuəs	kən'tɪnjʊəs	连续不断的； 延伸的
opponent	ə'pəunənt	ə'ponənt	对手， 敌手， 对抗者
accelerate	ək'seləreɪt	əkˈsɛləˌret	使加快， 使增速
backward	'bækwəd	'bækwɚd	[-]倒； 向后， 往回 / 向后的，倒的；落后的，进步慢的
grain	greɪn	ɡren	谷物， 谷粒； 颗粒； 少量， 微量
maid	meɪd	med	女仆， 侍女
residence	'rezɪdəns	'rɛzɪdəns	住处， 住宅； 居住； 居住资格
credit	'kredɪt	'krɛdɪt	信贷，赊欠；赞扬，荣誉；学分；信任 / 相信； 把…记入贷方； 把…归于
regardless	rɪ'gɑːdləs	rɪ'ɡɑrdləs	不顾后果地； 不管怎样， 无论如何
oxygen	'ɒksɪdʒən	'ɑksɪdʒən	氧， 氧气
intensive	ɪn'tensɪv	ɪn'tɛnsɪv	加强的； 精深的， 透彻的； 精耕细作的
alter	'ɔːltə	'ɔltɚ	改变， 变更， 变动
combine	kəm'baɪn	kəm'baɪn	结合， 联合； 化合 / 联合企业； 联合收割机
ideal	aɪ'diːəl	aɪ'diəl	理想的；观念的；空想的 / 理想； 理想的东西
bearing	'beərɪŋ	'bɛrɪŋ	举止， 风度； 方位， 方向感； 影响
illustrate	'ɪləstreɪt	'ɪləstret	说明
occur	ə'kɜː	ə'kɝ	发生， 出现， 存在； 被想起， 被想到
comedy	'kɒmədi	'kɑmədi	喜剧， 喜剧性
broom	bruːm	brum	扫帚
establishment	ɪ'stæblɪʃmənt	ɪ'stæblɪʃmənt	建立， 设立， 确立； 企业； 当权人物
pressure	'preʃə	'prɛʃɚ	压，压强；压迫 / 对…施加压力， 迫使
breeze	briːz	briz	飘然而行 / 微风，和风
trash	træʃ	træʃ	垃圾，废物；拙劣的文学作品；没用的人，社会渣滓，败类 / 捣毁， 破坏
painter	'peɪntə	'pentɚ	漆工； 画家
millimetre	'mɪliˌmiːtə	'mili,mi:tə	毫米
horn	hɒːn	hɔrn	角； 号角； 警报器
specialist	'speʃəlɪst	'spɛʃəlɪst	专家
infer	ɪn'fɜː	ɪn'fɝ	推论， 推断； 猜想
compass	'kʌmpəs	'kʌmpəs	罗盘， 指南针； 圆规； 界限， 范围
background	'bækgraund	'bækɡraʊnd	出身背景， 经历； 背景资料； 背景， 底子
sore	sɔː	sɔr	痛的；恼火的；急剧的，剧烈的 / 疮， 痛处
dispose	dɪ'spəuz	dɪ'spoz	处理， 解决； 使倾向于
glow	gləu	ɡlo	发白热光 / 白热光；脸红；激情
curtain	'kɜːtn	'kɝtn	门帘， 窗帘； 幕
laughter	'lɑːftə	'læftɚ	笑， 笑声
constitution	ˌkɒnstɪ'tjuːʃn	'kɑnstə'tʊʃən	宪法， 章程； 组成； 设立
blend	blend	blɛnd	混合
certificate	sə'tɪfɪkət	sɚˈtɪfɪkɪt; (for v.,) sɚˈtɪfɪˌket	证书， 证件， 执照
mess	mes	mɛs	凌乱状态，混乱的局面；困境 / 弄糟， 弄脏， 搞乱
sour	'sauə	'saʊɚ	酸的；馊的，酸味的；脾气坏的 / 变酸， 变馊； 变得乖戾
delete	dɪ'liːt	dɪ'lit	删除， 擦掉
nonsense	'nɒnsns	'nɑnsɛns	胡说， 废话； 冒失的行动
stain	steɪn	sten	玷污；给…着色 / 污点， 污迹
transform	træns'fɔːm	træns'fɔrm	使改观， 改革； 变换， 把…转换成
leadership	'liːdəʃɪp	'lidɚʃɪp	领导
genuine	'dʒenjuɪn	'dʒɛnjʊɪn	真的， 真正的； 真诚的
X-ray	'eks'reɪ	'eksreɪ	X射线， X光
physical	'fɪzɪkl	'fɪzɪkl	身体的； 物理的； 物质的， 有形的
fulfil	ful'fɪl	ful'fil	履行， 实现， 完成； 满足， 使满意
wicked	'wɪkɪd	'wɪkɪd	坏的， 令人厌恶的； 淘气的， 顽皮的
spokesman	'spəuksmən	'spoksmən	发言人
equation	ɪ'kweɪʒn	ɪ'kweʒn	方程， 等式
impressive	ɪm'presɪv	ɪm'prɛsɪv	给人深刻印象的
compound	'kɒmpaʊnd	'kɑmpaʊnd	复合的， 化合的 / 化合物，复合物；复合词 / 使恶化， 加重； 使化合， 使合成
structure	'strʌktʃə	'strʌktʃɚ	结构，构造 / 建造
intensity	ɪn'tensəti	ɪn'tɛnsəti	强烈， 剧烈； 强度
waken	'weɪkən	'wekən	醒来， 弄醒
stake	steɪk	stek	桩；利害关系；股份；赌金，赌注 / 以…打赌， 拿…冒险
extraordinary	ɪk'strɔːdnri	ɪkˈstrɔrdənerɪ; ɪkˈstrɔrdnˌɛrɪ	非同寻常的， 特别的
witness	'wɪtnəs	ˈwɪtnɪs	证据；目击者，证人 / 目击； 为…作证， 证明
concerning	kən'sɜːnɪŋ	kən'sɝnɪŋ	关于
attraction	ə'trækʃn	ə'trækʃən	吸引， 吸引力； 引力； 具有吸引力的事物
conventional	kən'venʃənl	kən'vɛnʃənl	普通的； 习惯的， 常规的； 因循守旧的
regulation	ˌregju'leɪʃn	ˌrɛɡjəˈleʃən	规章， 规则； 管理， 控制； 调节
puzzle	'pʌzl	'pʌzl	迷惑，为难；苦思 / 智力测验； 谜， 难题， 令人费解的事； 困惑， 迷惑
circulation	ˌsɜːkjə'leɪʃn	,sɝkjə'leʃən	循环； 流传； 发行， 流通
bake	beɪk	bek	烤， 烘， 焙
mere	mɪə	mɪr	仅仅的； 纯粹的
accommodation	əˌkɒmə'deɪʃn	ə,kɑmə'deʃən	住处； 膳宿
evident	'evɪdənt	'ɛvɪdənt	明显的， 明白的
suburb	'sʌbɜːb	'sʌbɝb	郊区， 郊外， 近郊
lodge	lɒdʒ	lɑdʒ	暂住，借宿 / 乡间小屋； 旅舍
threat	θret	θrɛt	威胁， 恐吓； 凶兆， 征兆
writer	'raɪtə	'raɪtɚ	作者， 作家
simplify	'sɪmplɪfaɪ	'sɪmplɪfaɪ	简化， 使简明
breast	brest	brɛst	乳房； 胸脯， 胸膛
invention	ɪn'venʃn	ɪn'vɛnʃən	发明， 创造； 捏造
mercy	'mɜːsi	'mɝsi	仁慈， 宽容； 恩惠； 幸运
annoy	ə'nɔɪ	ə'nɔɪ	使恼怒； 打搅
curl	kɜːl	kɝl	鬈发； 卷曲， 卷曲物
inform	ɪn'fɔːm	ɪn'fɔrm	告发， 告密 / 通知；报告
psychological	ˌsaɪkə'lɒdʒɪkl	,saɪkə'lɑdʒɪkl	心理的
glue	gluː	ɡlu	胶，胶水 / 胶合
commit	kə'mɪt	kə'mɪt	犯， 干； 使承诺； 把…托付给； 调拨…供使用， 拨出
scream	skriːm	skrim	尖叫，呼啸 / 尖叫声
sorrow	'sɒrəu	sɑro	悲痛， 悲哀， 悲伤； 伤心事， 不幸的事
crash	kræʃ	kræʃ	发出撞击声；垮台，破产；冲，闯 / 碰撞；坠落 / 碰撞； 破裂声
patch	pætʃ	pætʃ	补丁；斑，与周围不同的部分；一小块地 / 补， 修补
observer	əb'zɜːvə	əb'zɝvɚ	观察员， 观察者
character	'kærəktə	'kærɪktɚ	性格， 特性； 性质； 人物， 角色； 符号； 字
reflect	rɪ'flekt	rɪ'flɛkt	反映， 显示； 反射， 映现； 深思， 考虑， 反省
procession	prə'seʃn	prə'sɛʃən	队伍， 行列
contribution	ˌkɒntrɪ'bjuːʃn	,kɑntrɪ'bjuʃən	贡献， 促成作用； 捐款， 捐献物； 稿件
Marxist	'mɑːksɪst	'mɑrksɪst	马克思主义的 / 马克思主义者
bang	bæŋ	bæŋ	猛击， 猛撞； 发出砰的一声， 砰砰地响 / 巨响，枪声；猛击 / 猛击，猛撞；砰地敲
brow	brau	braʊ	额， 眉， 眉毛
meaning	'miːnɪŋ	'minɪŋ	意义， 意思； 目的； 重要性
ignorant	'ɪgnərənt	'ɪɡnərənt	不知道的， 无知的
magnetic	mæg'netɪk	mæg'nɛtɪk	磁的； 有吸引力的
band	bænd	bænd	乐队；群，伙；带；条纹；波段 / 用带绑扎
orbit	'ɔːbɪt	'ɔrbɪt	轨道 / 做轨道运行
comprise	kəm'praɪz	kəm'praɪz	包含， 包括， 构成
moderate	'mɒd(ə)rət	ˈmɑdərɪt; (for v.,) ˈmɑdərˌeɪt	中等的； 温和的， 稳健的； 有节制的 / 和缓， 减轻； 节制
resident	'rezɪdənt	'rɛzɪdənt	居住的， 定居的； 住校的， 住院的 / 居民，定居者；住院医生
spray	spreɪ	spreɪ	喷， 溅散 / 浪花，水花；喷雾
distinguish	dɪ'stɪŋgwɪʃ	dɪ'stɪŋɡwɪʃ	区别， 辨别， 识别； 使显出特色， 使杰出
receiver	rɪ'siːvə	rɪ'sivɚ	听筒； 接收器
outer	'autə	'aʊtɚ	外面的， 外层的
invent	ɪn'vent	ɪn'vɛnt	发明， 创造； 捏造
fluent	'fluːənt	'fluənt	流利的， 流畅的
shortcoming	'ʃɔːtkʌmɪŋ	'ʃɔrtkʌmɪŋ	短处， 缺点
substantial	səb'stænʃl	səbˈstænʃəl	可观的， 大量的； 结实的， 坚固的； 实质的， 真实的
execute	'eksɪkjuːt	'ɛksɪkjut	将…处死； 实施， 执行
benefit	'benɪfɪt	'bɛnɪfɪt	有益于； 得益 / 利益，恩惠；救济金，保险金，津贴
flood	flʌd	flʌd	淹没； 涌入 / 洪水；大量
vitamin	'vɪtəmɪn	'vaɪtəmɪn	维生素
intention	ɪn'tenʃn	ɪn'tɛnʃən	意图， 意向， 目的
rude	ruːd	rud	粗鲁的， 不礼貌的； 粗糙的， 粗陋的
symptom	'sɪmptəm	'sɪmptəm	症状； 征候， 征兆
pillar	'pɪlə	'pɪlɚ	柱， 柱子； 栋梁
thereby	ˌðeə'baɪ	,ðɛr'baɪ	因此， 从而， 由此
unique	ju'niːk	jʊ'nik	唯一的， 独一无二的； 极不寻常的， 极好的
funeral	'fjuːnərəl	'fjunərəl	葬礼， 丧礼， 丧葬
boost	buːst	bʊst	提高，使增长；推动，激励；替…做广告，宣扬 / 提高， 增长； 推动， 激励
fireman	'faɪəmən	'faɪrmən	消防队员； 司炉工
sincere	sɪn'sɪə	sɪn'sɪr	真诚的， 诚挚的
male	meɪl	mel	男的，雄的 / 男子， 雄性动物
ministry	'mɪnɪstri	'mɪnɪstri	部
religious	rɪ'lɪdʒəs	rɪ'lɪdʒəs	宗教的； 笃信宗教的， 虔诚的
nevertheless	ˌnevəðə'les	,nɛvɚðə'lɛs	仍然， 然而
prominent	'prɒmɪnənt	'prɑmɪnənt	突出的， 杰出的； 突起的， 凸出的
shelter	'ʃeltə	'ʃɛltɚ	掩蔽处，躲避处；住所；掩蔽，保护 / 掩蔽， 庇护； 躲避
outset	'autset	'aʊtsɛt	开始， 开端
jewel	'dʒuːəl	'dʒuəl	宝石； 宝石饰物
scan	skæn	skæn	细看，审视；扫描，浏览 / 扫描
association	əˌsəusi'eɪʃn	ə,soʃɪ'eʃən	协会， 团体； 联合， 交往
fundamental	ˌfʌndə'mentl	,fʌndə'mɛntl	基础的，基本的 / 基本原则
eliminate	ɪ'lɪmɪneɪt	ɪ'lɪmɪnet	消灭， 消除， 排除； 淘汰
global	'gləubl	'ɡlobl	全球的， 全世界的； 总的， 完整的
entitle	ɪn'taɪtl	ɪn'taɪtl	给…权利； 给题名
outline	'autlaɪn	'aʊtlaɪn	提纲，要点；外形，略图 / 概述； 描…外形
fade	feɪd	fed	褪色；逐渐消失；凋谢 / 使褪色
unless	ən'les	ən'lɛs	除非， 如果不
butterfly	'bʌtəflaɪ	'bʌtɚflaɪ	蝴蝶
excess	ɪk'ses; ek-; 'ekses	'ɛk'sɛs	过量的， 额外的 / 超越； 过量， 过度
glance	glɑːns	ɡlæns	看一下 / 一瞥 / 用扫视； 反射
perspective	pə'spektɪv	pɚ'spɛktɪv	视角， 观点； 远景， 景观； 透视画法， 透视图
relationship	rɪ'leɪʃnʃɪp	rɪ'leʃən'ʃɪp	关系， 关联
equality	iː'kwɒləti	ɪ'kwɑləti	等同， 平等， 相等
destruction	dɪ'strʌkʃn	dɪ'strʌkʃən	破坏， 毁灭， 消灭
dictation	dɪk'teɪʃn	dɪk'teʃən	口授； 听写
stiff	stɪf	stɪf	极其， 非常； 僵硬地 / 硬的，僵直的；不灵活的；拘谨的，生硬的；费劲的；强烈的
expression	ɪk'spreʃn	ɪk'sprɛʃən	词语； 表达； 表情
invade	ɪn'veɪd	ɪn'ved	入侵， 侵略， 侵袭
reaction	ri'ækʃn	rɪ'ækʃən	反应； 反作用
childhood	'tʃaɪldhud	'tʃaɪldhʊd	童年， 幼年， 早期
wolf	wulf	wʊlf	狼
accordance	ə'kɔːdns	ə'kɔrdns	一致； 和谐
thorough	'θʌrə	ˈθʌrəʊ; θʌro	彻底的， 详尽的
appeal	ə'piːl	ə'pil	呼吁，恳求；申诉，上诉 / 上诉 / 感染力， 吸引力； 呼吁， 上诉
democracy	dɪ'mɒkrəsi	dɪˈmɑkrəsi	民主， 民主制； 民主国家
transportation	ˌtrænspɔː'teɪʃn	,trænspɔr'teʃən	运输， 运送， 客运
dye	daɪ	daɪ	染 / 染料； 染色
evolve	i'vɒlv	ɪ'vɑlv	使进化， 使发展
extensive	ɪk'stensɪv	ɪk'stɛnsɪv	广阔的， 广泛的
congratulation	kənˌgrætʃu'leɪʃn	kən,ɡrætʃu'leʃən	贺词； 祝贺， 恭喜
abandon	ə'bændən	ə'bændən	离弃，丢弃；遗弃，抛弃；放弃 / 放任； 纵情
definitely	'defɪnətli	'dɛfɪnətli	一定地， 明确地
inspire	ɪn'spaɪə	ɪn'spaɪɚ	吸气； 赋予灵感 / 鼓舞，给…以灵感
marvelous	'mɑːvələs	'mɑrvələs	奇迹般的， 了不起的
household	'haushəuld	'haʊshold	家庭的； 家喻户晓的 / 家庭，户；家务
geometry	dʒi'ɒmətri	dʒɪ'ɑmətri	几何， 几何学
ratio	'reɪʃiəu	'reʃɪo	比， 比率
devote	dɪ'vəut	dɪ'vot	将…奉献给； 把…专用
agent	'eɪdʒənt	'edʒənt	代理人， 代理商； 政府代表； 动因， 原因； 剂
wool	wul	wʊl	羊毛； 毛线， 绒线
wholly	'həulli	'holli	完全地， 全部地
instinct	'ɪnstɪŋkt	'ɪnstɪŋkt	本能， 天性； 直觉
approximate	ə'prɒksɪmət	ə'prɑksɪmət	近似的 / 近似； 估计
invest	ɪn'vest	ɪn'vɛst	投资， 投入； 授予
afterward	'ɑːftəwəd	ˈæftərwərd	后来， 以后
reputation	ˌrepju'teɪʃn	,rɛpju'teʃən	名誉， 名气， 名声
project	prəˈdʒekt; ˈprɒdʒekt	prəˈdʒɛkt; prɑdʒɛkt	伸出； 投射； 预计 / 方案， 计划； 课题， 项目； 工程
shrug	ʃrʌg	ʃrʌɡ	耸肩
independence	ˌɪndɪ'pendəns	,ɪndɪ'pɛndəns	独立， 自主， 自立
coordination	kəuˌɔːdɪ'neɪʃn	ko,ɔrdɪ'neʃən	同等； 调和
presentation	ˌprezn'teɪʃn	,prizɛn'teʃən	提供， 显示； 外观， 图像； 授予， 赠送； 报告， 介绍； 表演
diameter	daɪ'æmɪtə	daɪ'æmɪtɚ	直径
barn	bɑːn	bɑrn	谷仓； 牲口棚
bark	bɑːk	bɑrk	吠，叫 / 吠声， 叫声； 树皮
loop	luːp	lup	成环， 成圈 / 圈，环，回路；循环
restrain	rɪ'streɪn	rɪ'stren	阻止， 控制； 抑制， 遏制
greedy	'griːdi	'gridi	贪吃的； 贪婪的； 渴望的
awkward	'ɔːkwəd	'ɔkwɚd	笨拙的， 尴尬的； 难操纵的， 使用不便的； 不灵巧的
bare	beə	bɛr	赤裸的；光秃的，无遮盖的；刚刚够的，勉强的 / 露出， 显露
ruin	'ruːɪn	'ruɪn	毁坏 / 毁灭；废墟
crane	kreɪn	kren	起重机， 摄影升降机； 鹤
beard	bɪəd	bɪrd	胡须， 络腮胡子
impatient	ɪm'peɪʃnt	ɪm'peʃnt	不耐烦的， 急躁的
spill	spɪl	spɪl	溢出，洒落 / 溢出
owing	'əuɪŋ	'oɪŋ	应付的， 未付的
collection	kə'lekʃn	kə'lɛkʃən	搜集， 聚集， 积聚； 收集， 收取； 收藏品， 收集的东西
gardener	'gɑːdnə	'gɑrdənɚ	园丁， 花匠
conquest	'kɒŋkwest	'kɑŋkwɛst	攻取， 征服， 克服
finding	'faɪndɪŋ	'faɪndɪŋ	发现； 调查的结果； 裁决
dense	dens	dɛns	密集的， 浓厚的； 密度大的
fortnight	'fɔːtnaɪt	'fɔrtnaɪt	两星期， 十四天
laboratory	lə'bɒrətri	ˈlæbrəˌtɔrɪ	实验室， 研究室
inspect	ɪn'spekt	ɪn'spɛkt	进行检查； 进行视察 / 检查，审查；检阅
campaign	kæm'peɪn	kæm'pen	参加运动； 参加竞选 / 战役；运动
systematical	ˌsɪstə'mætɪk(l)	,sistə'mætikl	有系统的， 有计划的
vital	'vaɪtl	'vaɪtl	致命的， 生死攸关的； 极其重要的； 生命的， 有生命力的
conflict	'kɒnflɪkt	'kɑnflɪkt	冲突， 抵触 / 冲突， 抵触， 争论； 战斗， 战争
farewell	ˌfeə'wel	,fɛr'wɛl	告别， 欢送会
allow	ə'lau	ə'laʊ	允许， 准许； 同意给； 承认； 允许…进入
appliance	ə'plaɪəns	ə'plaɪəns	用具， 器具， 器械； 家电
mass	mæs	mæs	大量的，大规模的 / 聚集， 集中 / 众多，大量；团，块，堆；群众；质量
lord	lɔːd	lɔrd	领主， 君主， 贵族
detect	dɪ'tekt	dɪ'tɛkt	察觉， 发觉； 侦查出
amateur	'æmətə	ˈæmətər	业余爱好的， 业余的； 外行的 / 业余爱好者；外行
poisonous	'pɔɪzənəs	'pɔɪzənəs	有毒的； 恶毒的
condemn	kən'dem	kən'dɛm	谴责， 指责； 判…刑， 宣告…有罪
beast	biːst	bist	兽， 野兽， 牲畜； 凶残的人， 令人厌憎的人
assistance	ə'sɪstəns	ə'sɪstəns	协助， 援助
commerce	'kɒmɜːs	'kɑmɝs	商业， 贸易； 社交
gesture	'dʒestʃə	'dʒɛstʃɚ	做手势 / 姿势，手势，姿态
admit	əd'mɪt	əd'mɪt	承认， 供认； 准许…进入
poem	'pəuɪm	'poəm	诗
interest	'ɪntrəst;'ɪntrest	'ɪntrəst	兴趣；利益，利害关系；利息 / 使感兴趣
gulf	gʌlf	ɡʌlf	海湾； 巨大的分歧
poet	'pəuɪt	'poət	诗人
definition	ˌdefɪ'nɪʃn	,dɛfɪ'nɪʃən	定义， 释义， 定界； 清晰， 鲜明
shave	ʃeɪv	ʃev	剃，刮，刨，削；修面，刮脸 / 修面， 刮脸
organic	ɔː'gænɪk	ɔr'gænɪk	有机体的， 有机物的
mask	mɑːsk	mæsk	面具，面罩，口罩；伪装 / 遮盖， 掩饰
summary	'sʌməri	'sʌməri	概括的， 概要的； 实时的， 即决的 / 摘要，概要，一览
apply	ə'plaɪ	ə'plaɪ	适用； 申请， 请求； 涂， 敷， 施 / 应用，实施；使用；涂敷；把…施于
inferior	ɪn'fɪəriə	ɪn'fɪrɪɚ	下等的，劣等的；次于…的 / 下级， 下属
steamer	'stiːmə	'stimɚ	轮船， 汽船
recently	'riːsntli	'risntli	最近， 新近
overlook	ˌəuvə'luk	,ovɚ'lʊk	忽视； 宽恕； 俯瞰
politician	ˌpɒlə'tɪʃn	,pɑlə'tɪʃən	政治家， 政客
incredible	ɪn'kredəbl	ɪn'krɛdəbl	不能相信的， 不可信的； 难以置信的， 不可思议的； 惊人的
dramatic	drə'mætɪk	drə'mætɪk	引人注目的， 激动人心的； 突然的
mosquito	mə'skiːtəu	məˈskiːtoʊ	蚊子
guitar	gɪ'tɑː	ɡɪ'tɑr	吉他， 六弦琴
layout	'leɪaut	'leaʊt	布局， 安排， 设计
artificial	ˌɑːtɪ'fɪʃl	,ɑrtɪ'fɪʃl	人工的， 人为的； 矫揉造作的； 模拟的
imaginary	ɪ'mædʒɪnəri	ɪ'mædʒɪnɛri	想象中的， 假想的
removal	rɪ'muːvl	rɪ'muvl	除去， 消除； 移动， 搬迁
formula	'fɔːmjələ	'fɔrmjələ	公式， 方程式； 原则， 方案； 配方
comment	'kɒment	'kɑmɛnt	评论 / 评论，意见，注释；闲话，议论
revolt	rɪ'vəult	rɪ'volt	反叛，起义；反抗，违抗；厌恶，生反感 / 反叛， 起义
disgust	dɪs'gʌst	dɪs'ɡʌst	厌恶， 憎恶
stem	stem	stɛm	起源 / 茎，干；词干 / 堵住， 止住， 停住
sunshine	'sʌnʃaɪn	'sʌnʃaɪn	日光， 阳光
trend	trend	trɛnd	伸向；倾向 / 倾向
achievement	ə'tʃiːvmənt	ə'tʃivmənt	完成； 成就， 成绩
mechanic	mə'kænɪk	mə'kænɪk	技工， 机修工； 力学， 机械学； 过程， 方法， 技术性细节
desirable	dɪ'zaɪərəbl	dɪ'zaɪərəbl	值得向往的， 令人满意的
balcony	'bælkəni	'bælkənɪ	阳台； 楼厅， 楼座
consist	kən'sɪst	kən'sɪst	由…组成； 在于； 一致
preparation	ˌprepə'reɪʃn	,prɛpə'reʃən	准备， 预备； 制剂
reliable	rɪ'laɪəbl	rɪ'laɪəbl	可靠的， 可信赖的
relate	rɪ'leɪt	rɪ'let	有关， 涉及； 符合； 相处 / 使有关联；讲述，叙述
critic	'krɪtɪk	'krɪtɪk	批评家， 爱挑剔的人
elevator	'elɪveɪtə	'ɛlɪvetɚ	电梯， 升降机
grammar	'græmə	'græmɚ	语法； 语法书
enable	ɪ'neɪbl	ɪ'nebl	使能够， 使可能
preliminary	prɪ'lɪmɪnəri	prɪ'lɪmɪnɛri	预备的，初步的 / 初步做法， 起始行为
dependent	dɪ'pendənt	dɪ'pɛndənt	依靠的， 依赖的； 取决于…的
obstacle	'ɒbstəkl	'ɑbstəkl	障碍， 障碍物， 妨碍
profession	prə'feʃn	prə'fɛʃən	职业； 声明， 表白
calculator	'kælkjuleɪtə	'kælkjuletɚ	计算器， 计算者
van	væn	væn	大篷车， 运货车
biology	baɪ'ɒlədʒi	baɪ'ɑlədʒi	生物学， 生态学
worm	wɜːm	wɝm	虫， 蠕虫
compress	kəm'pres	kəm'prɛs	压紧， 压缩
arise	ə'raɪz	ə'raɪz	出现； 由…引起； 起身， 起床
collaborative	kə'læbərətɪv	kə'læbəretɪv	合作的， 协作的， 协力完成的
cherish	'tʃerɪʃ	'tʃɛrɪʃ	珍爱； 怀有
constitute	'kɒnstɪtjuːt	'kɑnstətut	组成， 形成； 设立； 任命
cattle	'kætl	'kætl	牛； 牲口， 家畜
imagination	ɪˌmædʒɪ'neɪʃn	ɪ,mædʒɪ'neʃən	想象， 想象力， 空想； 想象出
resistance	rɪ'zɪstəns	rɪ'zɪstəns	反抗， 抵制； 抵抗力， 抵抗性； 阻力； 电阻
underneath	ˌʌndə'niːθ	,ʌndɚ'niθ	在下面，在底下 / 在…下面，在…底下 / 下部， 底部
nursery	'nɜːsəri	'nɝsəri	托儿所， 保育室； 苗圃
mate	meɪt	met	成为配偶， 交配 / 伙伴，同事；配偶，配对物；大副
convince	kən'vɪns	kən'vɪns	使确信， 使信服， 说服
emperor	'empərə	'ɛmpərɚ	皇帝
prolong	prə'lɒŋ	prəˈlɑːŋ	拉长， 延长
theory	'θɪəri	'θiəri	理论， 原理； 学说； 意见， 看法
distress	dɪ'stres	dɪ'strɛs	忧虑， 痛苦， 悲伤； 不幸
flock	flɒk	flɑk	羊群， 群； 大量
internal	ɪn'tɜːnl	ɪn'tɝnl	内的； 国内的； 内心的
extension	ɪk'stenʃn	ɪk'stɛnʃən	延长部分， 伸展； 电话分机， 分机号码
signature	'sɪgnətʃə	'sɪgnətʃɚ	署名， 签字， 签名
steep	stiːp	stip	险峻的， 陡峭的； 过高的； 急剧的
thumb	θʌm	θʌm	示意要求搭车 / 拇指
republican	rɪ'pʌblɪkən	rɪ'pʌblɪkən	共和政体的；共和党的 / 共和党人
literary	'lɪtərəri	lɪtərɛri	文学的； 文人的， 书卷气的
architect	'ɑːkɪtekt	'ɑrkɪtɛkt	建筑师， 设计师； 缔造者
forehead	'fɔːh3d; 'fɒrɪd	'fɔr'hɛd	额头； 前部
classical	'klæsɪkl	'klæsɪkl	古典的， 经典的
privilege	'prɪvəlɪdʒ	ˈprɪvəlɪdʒ	特权； 优惠
foundation	faun'deɪʃn	faʊn'deʃən	基础；
substitute	'sʌbstɪtjuːt	'sʌbstɪtut	代替人；代用品 / 用…代替
punch	pʌntʃ		猛击；穿孔 / 猛击； 冲床； 穿孔机； 力量， 效力
naturally	'nætʃrəli	'nætʃrəli	当然； 天然地； 天生地
flexibility	ˌfleksə'bɪləti	,flɛksə'bɪləti	灵活性， 机动性， 柔韧性
mysterious	mɪ'stɪəriəs	mɪ'stɪrɪəs	神秘的， 诡秘的
moreover	mɔːr'əuvə	mɔr'ovɚ	而且， 再者， 此外
identity	aɪ'dentətɪ	aɪ'dɛntəti	身份； 个性， 特性； 同一性， 一致性
scatter	'skætə	'skætɚ	撒， 散播； 散开， 驱散
installation	ˌɪnstə'leɪʃn	'ɪnstə'leʃən	安装； 装置， 设施； 就任， 就职
writing	'raɪtɪŋ	'raɪtɪŋ	书写， 写； 著作
federal	'fedərəl	'fɛdərəl	联邦的， 联盟的
violate	'vaɪəleɪt	'vaɪəlet	违反， 违背； 亵渎； 侵犯； 妨碍
verify	'verɪfaɪ	'vɛrɪfaɪ	证实， 查证， 证明
collective	kə'lektɪv	kə'lɛktɪv	集体的，集合性的 / 团体， 集体
excursion	ɪk'skɜːʃn	ɪk'skɝʒn	远足， 短途旅行
steer	stɪə	stɪr	掌舵， 驾驶； 操纵
event	ɪ'vent	ɪ'vɛnt	事件， 大事， 事变
academy	ə'kædəmi	ə'kædəmi	研究会， 学会； 专门学校
undergo	ˌʌndə'gəu	,ʌndɚ'ɡo	经历， 经受， 忍受； 接受
reward	rɪ'wɔːd	rɪ'wɔrd	报答，奖赏；报酬，酬金 / 报答， 酬谢， 奖励
include	ɪn'kluːd	ɪn'klud	包括， 包含
sympathize	'sɪmpəθaɪz	'sɪmpə'θaɪz	同情， 怜悯； 体谅； 赞同
alongside	əˌlɒŋ'saɪd	ə'lɔŋ'saɪd	在旁边，沿着边，并排地 / 在…旁边， 沿着…的边； 和…在一起
swallow	'swɒləu	'swɑlo	燕子；吞，咽 / 吞， 咽； 轻信， 轻易接受； 承受， 使不流露； 咽下口水
agency	'eɪdʒənsi	'edʒənsi	经办， 代理； 代理处； 专门行政部门
coupon	'kuːpɒn	'kupɑn	礼券， 优惠券， 配给券； 联票； 票证
railroad	'reɪlrəud	'relrod	铁路 / 由铁路运输
nucleus	'njuːkliəs	'nuklɪəs	核心； 核
fascinating	'fæsɪneɪtɪŋ	'fæsɪnetɪŋ	迷人的， 有极大吸引力的
abstract	'æbstrækt	'æbstrækt	抽象的，抽象派的 / 摘要， 梗概； 抽象派艺术作品 / 做…的摘要； 提取
sting	stɪŋ	stɪŋ	刺，蜇，叮 / 刺伤处，蜇伤处
haste	heɪst	hest	急速， 急忙； 草率
agenda	ə'dʒendə	ə'dʒɛndə	议事日程
appearance	ə'pɪərəns	ə'pɪrəns	出现， 来到； 外观
liquid	'lɪkwɪd	'lɪkwɪd	液体的； 清澈的； 流畅的 / 液体
culture	'kʌltʃə	'kʌltʃɚ	文化， 文明； 教养； 培养； 培养菌
sleeve	sliːv	sliv	袖子， 袖套
devotion	dɪ'vəuʃn	dɪ'voʃən	献身， 奉献； 忠实； 热爱； 虔诚
anonymous	ə'nɒnɪməs	ə'nɑnəməs	匿名的； 无名的； 无特色的
stir	stɜː	stɝ	搅动；拨动；激动；唤起 / 搅拌， 搅动； 激动， 骚乱
fisherman	'fɪʃəmən	'fɪʃɚmən	渔民， 渔夫
span	spæn	spæn	跨距，一段时间 / 持续， 贯穿； 包括； 横跨， 跨越
insult	ɪn'sʌlt	ɪn'sʌlt	侮辱， 凌辱 / 侮辱， 凌辱
existence	ɪg'zɪstəns	ɪɡ'zɪstəns	存在， 实在， 生存
craft	krɑːft	kræft	工艺， 手艺； 船， 航空器
butcher	'butʃə	ˈbʊtʃər	肉商，肉贩，屠夫 / 屠宰， 残杀
poll	pəul	pol	民意测验；政治选举，大选 / 对…进行民意测验； 获得
minority	maɪ'nɒrəti	maɪ'nɔrəti	少数； 少数民族
pole	pəul	pol	杆； 极， 磁极， 电极
float	fləut	flot	浮动， 漂浮； 飘动
graceful	'greɪsfl	'ɡresfl	优美的， 优雅的； 得体的
fourfold	'fɔːfəuld	'fɔrfold	四倍， 四重 / 四倍的，四重的
preferable	'prefrəbl	'prɛfrəbl	更可取的， 更好的， 更合意的
reference	'refrəns	'rɛfrəns	提到， 论及； 参考； 引文； 参考书目； 证明书， 证明人
frog	frɒg	frɔɡ	蛙
spite	spaɪt	spaɪt	恶意，怨恨 / 刁难， 欺侮
chamber	'tʃeɪmbə	ˈtʃeɪmbər	会议室， 会所； 房间； 腔， 室
arrange	ə'reɪndʒ	ə'rendʒ	安排， 准备， 整理
coarse	kɔːs	kɔrs	粗的， 粗糙的； 粗劣的； 粗俗的
nephew	'nevjuː; 'nefjuː	'nɛfju	侄子， 外甥
publicity	pʌb'lɪsəti	pʌb'lɪsəti	公众的注意， 名声； 宣传， 宣扬
depart	dɪ'pɑːt	dɪ'pɑrt	离开， 起程， 出发
exaggerate	ɪg'zædʒəreɪt	ɪɡ'zædʒəret	夸大， 夸张
imply	ɪm'plaɪ	ɪm'plai	暗示， 意指
capture	'kæptʃə	'kæptʃɚ	捕获， 俘获； 夺得
commitment	kə'mɪtmənt	kə'mɪtmənt	承诺， 许诺， 保证； 信奉， 献身； 承担的义务
spade	speɪd	sped	铲， 铁锹
manufacture	ˌmænju'fæktʃə	'mænjə'fæktʃɚ	制造，加工 / 制造， 制造业
sequence	'siːkwəns	'sikwəns	连续， 接续， 一连串； 次序， 顺序
collision	kə'lɪʒn	kə'lɪʒən	碰撞； 冲突， 抵触
qualification	ˌkwɒlɪfɪ'keɪʃn	,kwɑlɪfɪ'keʃən	资格， 资格证明， 合格证书； 限制， 限定
provision	prə'vɪʒn	prə'vɪʒn	供应； 准备； 条款， 规定； 给养， 口粮
recruit	rɪ'kruːt	rɪ'krut	招募，吸收 / 新兵； 新成员
thrust	θrʌst	θrʌst	插；戳，刺 / 戳， 刺； 要点， 要旨； 推力
fame	feɪm	fem	名声， 名望
replacement	rɪ'pleɪsmənt	rɪ'plesmənt	代替， 取代； 更换， 调换； 替代的人
mud	mʌd	mʌd	泥， 泥浆
mug	mʌg	mʌɡ	大杯 / 对…行凶抢劫
pond	pɒnd	pɑnd	池塘
arrival	ə'raɪvl	ə'raɪvəl	到达， 到来； 到达者， 到达物
scientific	ˌsaɪən'tɪfɪk	,saɪən'tɪfɪk	科学的
frequent	'friːkwənt	'frikwənt	时常发生的，常见的 / 常到， 常去
according	ə'kɔːdɪŋ	ə'kɔrdɪŋ	相等的， 一致的， 依…而定的
insure	ɪn'ʃuə	ɪn'ʃʊr	为…投保； 确保
powder	'paudə	'paʊdɚ	粉， 粉末
membership	'membəʃɪp	'mɛmbɚʃɪp	会员身份， 会籍； 全体会员， 会员数
error	'erə	'ɛrɚ	错误， 谬误， 差错
platform	'plætfɔːm	'plæt'fɔrm	平台， 站台， 讲台； 纲领， 宣言
network	'netwɜːk	'nɛtwɝk	网状物； 广播网， 电视网； 网络
jealous	'dʒeləs	'dʒɛləs	妒忌的， 猜疑的； 精心守护的
rust	rʌst	rʌst	生锈， 氧化 / 铁锈
trace	treɪs	tres	痕迹；丝毫，少许 / 跟踪； 追溯； 描摹
Negro	'niːgrəu	'nigro	黑人
modernization	ˌmɒdənaɪ'zeɪʃn	,mɑdɚnə'zeʃən	现代化
grave	greɪv	ɡrev	严重的； 严肃的 / 坟墓
criminology	ˌkrɪmɪ'nɒlədʒi	,krɪmɪ'nɑlədʒi	犯罪学， 刑事学
advantage	əd'vɑːntɪdʒ	əd'væntɪdʒ	优点， 优势， 好处
assistant	ə'sɪstənt	ə'sɪstənt	助理的， 辅助的 / 助手，助理，助教
inn	ɪn	ɪn	小旅店， 小酒店
instead	ɪn'sted	ɪn'stɛd	作为替代； 却， 反而
controversy	'kɒntrəvɜːsi	ˈkɑntrəvɝ​sɪ	争论， 辩论
command	kə'mɑːnd	kə'mænd	命令， 指挥， 控制
newsstand	'njuːzstænd	'njʊz,stænd	报摊， 杂志摊
worthless	'wɜːθləs	ˈwərthləs	无价值的， 无用的
performance	pə'fɔːməns	pɚ'fɔrməns	演出； 执行， 完成； 工作情况， 表现； 工作性能
dessert	dɪ'zɜːt	dɪ'zɝt	甜食， 点心
ambassador	æm'bæsədə	æm'bæsədɚ	大使， 使节， 派驻国际组织的代表
anticipate	æn'tɪsɪpeɪt	æn'tɪsə'pet	预料， 预期， 期望； 先于…行动； 提前使用
variable	'veəriəbl	'vɛrɪəbl	易变的 / 变量
temple	'templ	'tɛmpl	圣堂， 神殿， 庙宇
growth	grəuθ	ɡroθ	增长， 增长量； 生长， 生长物
landscape	'lændskeɪp	ˈlændskep	风景，景色；风景画；全景 / 美化…的景观
weave	wiːv	wiv	织， 编
carrot	'kærət	'kærət	胡萝卜
normally	'nɔːməli	'nɔrmli	通常； 正常地
exception	ɪk'sepʃn	ɪk'sɛpʃən	例外， 除外
vague	veɪg	veɡ	模糊的， 含糊的
temporary	'temprəri	ˈtempəreri	暂时的， 临时的
fare	feə	fɛr	进展 / 车费，船费，票价
desperate	'despərət	'dɛspərət	拼死的， 不顾一切的； 绝望的； 极需要的
leading	'liːdɪŋ	'lidɪŋ	指导的， 带头的； 最主要的； 饰演主角的
awful	'ɔːfl	'ɔfl	令人不愉快的， 难过的； 非常的， 极大的
accuracy	'ækjərəsi	'ækjərəsi	准确， 精确
handy	'hændi	'hændi	手边的， 便于使用的
urge	ɜːdʒ	ɝdʒ	鼓励；推进，催促；竭力主张，强烈要求 / 冲动， 强烈的欲望
resolution	ˌrezə'luːʃn	,rɛzə'luʃən	正式决定， 决议； 决心， 决意； 解决， 解答； 分辨率， 清晰度
via	'vaɪə;'viːə	ˈvaɪə, ˈviə	经过， 通过
setting	'setɪŋ	'sɛtɪŋ	环境， 背景， 布景； 调节， 设定的位置
score	skɔː	skɔ	得， 给…打分； 画线于， 做记号于； 赢得 / 得分，比数，成绩；二十
quote	kwəut	kwot	引用，援引 / 引文， 引语； 报价， 牌价； 引号
graduate	ˈɡradʒʊeɪt	ˈɡrædʒuˌet	研究生的 / 毕业 / 毕业生；研究生
famine	'fæmɪn	'fæmɪn	饥荒； 严重的缺乏
gramme	græm	ɡræm	gram的英式拼法
absent	'æbsənt	ˈæbsnt;(for v.)əbˈsɛnt	缺席的， 不在场的； 缺乏的， 不存在的； 心不在焉的
rag	ræg	ræɡ	破布， 碎布； 破旧衣服
visual	'vɪʒuəl	'vɪʒʊəl	看得见的 / 视觉资料
understanding	ˌʌndə'stændɪŋ	,ʌndɚ'stændɪŋ	体谅的， 宽容的， 通情达理的 / 理解，理解力；谅解；协议；相互理解，融洽
empire	'empaɪə	'ɛmpaɪr	帝国
educate	'edʒʊkeɪt	'ɛdʒuket	教育， 培养， 训练
fairy	'feəri	'fɛri	小精灵， 小仙子
ashamed	ə'ʃeɪmd	ə'ʃemd	惭愧的， 羞耻的， 害臊的
instruct	ɪn'strʌkt	ɪn'strʌkt	指示， 命令； 通知； 教授， 训练
rat	ræt	ræt	鼠
mayor	meə	'meɚ	市长
virtually	'vɜːtʃuəli	ˈvɜrtʃuəli	实际上， 事实上
fairly	'feəli	'fɛrli	相当， 尚可， 还； 公平地
handwriting	'hændraɪtɪŋ	'hænd'raɪtɪŋ	笔迹， 手迹； 书法
merchant	'mɜːtʃənt	'mɝtʃənt	商人
raw	rɔː	rɔ	自然状态的， 未加工过的； 生的； 未经分析的， 原始的； 生疏无知的， 未经训练的； 露肉而刺痛的
proportional	prə'pɔːʃənl	prə'pɔrʃənl	比例的， 成比例的
economy	ɪ'kɒnəmi	ɪˈkɑnəmɪ	经济； 节约， 节省
community	kə'mjuːnəti	kəˈmjunətɪ	社区， 社会， 公社； 团体， 界； 群落
packet	'pækɪt	'pækɪt	小包， 小盒
version	'vɜːʃn;'vɜːʒn	'vɝʒn	译本； 说法； 改写本
airport	'eəpɔːt	'ɛrpɔrt	机场， 航空港
courtyard	'kɔːtjɑːd	'kɔrtjɑrd	庭院， 院子
nationality	ˌnæʃə'næləti	,næʃə'næləti	国籍； 民族
selection	sɪ'lekʃn	sɪ'lɛkʃən	选择， 挑选； 被挑选出来的人， 精选品； 可供选择的东西
institute	'ɪnstɪtjuːt	'ɪnstɪtut	研究所，学院 / 建立， 设立
aboard	ə'bɔːd	ə'bɔrd	在船上， 上船
endure	ɪn'djuə	ɪn'dʊr	忍受， 容忍； 持久， 持续
detail	'diːteɪl	dɪˈtel	细节，枝节；零件 / 详细说明
shortly	'ʃɔːtli	'ʃɔrtli	立刻， 不久； 不耐烦地； 简短地
hobby	'hɒbi	'hɑbi	业余爱好， 癖好
appropriate	ə'prəupriət	əˈproprɪət;(for v.) əˈproprɪet	适当的， 恰当的
providing	prə'vaɪdɪŋ	prə'vaɪdɪŋ	倘若
fate	feɪt	fet	命运， 天数
throat	θrəut	θrot	咽喉， 喉咙； 嗓音
utility	juː'tɪləti	ju'tɪləti	效用， 有用， 实用； 公用事业
immediately	ɪ'miːdiətli	ɪ'midɪətli	立即， 马上； 直接地， 紧接地
manual	'mænjuəl	'mænjuəl	用手的；手工做的 / 手册， 指南
measurement	'meʒəmənt	'mɛʒɚmənt	衡量， 测量； 尺寸， 大小
optimistic	ˌɒptɪ'mɪstɪk	,ɑptɪ'mɪstɪk	乐观的， 乐观主义的
vocabulary	və'kæbjələri	və'kæbjəlɛri	词汇表， 词汇， 语汇
retire	rɪ'taɪə	rɪ'taɪɚ	退休， 退役； 退下， 退出， 撤退； 就寝
aspect	'æspekt	'æspɛkt	方面； 朝向， 方向； 样子， 外表
particle	'pɑːtɪkl	'pɑrtɪkl	粒子， 微粒； 小品词， 语助词
aggressive	ə'gresɪv	ə'ɡrɛsɪv	侵略的， 好斗的； 敢做敢为的； 有进取心的
behavior	bɪ'heɪvjə	bɪ'hevjɚ	行为， 举止， 表现
musician	mju'zɪʃn	mjʊ'zɪʃən	音乐家， 乐师
minimize	'mɪnɪmaɪz	'mɪnɪmaɪz	将…减少； 最小化
descend	dɪ'send	dɪ'sɛnd	下来， 下降； 下倾
saint	seɪnt	sent	圣徒； 圣人， 道德高尚的人； [用于人名或地名等前]圣
density	'densəti	'dɛnsəti	密集， 稠密； 密度
logical	'lɒdʒɪkl	'lɑdʒɪkl	逻辑的， 合乎常理的
oblige	ə'blaɪdʒ	ə'blaɪdʒ	迫使； 施恩于， 帮…的忙； 使感激
slam	slæm	slæm	砰地关上；猛力拉，砰地放下；猛烈抨击 / 砰的一声
characterize	'kærəktəraɪz	'kærəktə'raɪz	成为…的特征， 以…为特征； 描绘的特性， 描述
swing	swɪŋ	swɪŋ	摇摆，回转；突然转向 / 摇摆； 秋千
ridiculous	rɪ'dɪkjələs	rɪ'dɪkjələs	荒谬的， 可笑的
handbag	'hændbæg	'hænd'bæg	手提包
invasion	ɪn'veɪʒn	ɪn'veʒn	入侵， 侵略， 侵犯
spin	spɪn	spɪn	旋转；晕眩；纺，织；绞干，甩干 / 旋转， 自转
severe	sɪ'vɪə	səˈvɪr	严重的； 严厉的， 严格的； 严峻的， 艰难的； 朴素的， 不加装饰的
emerge	i'mɜːdʒ	ɪ'mɝdʒ	出现， 涌现， 冒出
shallow	'ʃæləu	'ʃælo	浅的；浅薄的 / 浅滩， 浅水处
lease	liːs	lis	租约，租契 / 出租； 租得， 租有
exploit	ˈeksplɔɪt;ɪkˈsplɔɪt	ɛksplɔɪt; ɪkˈsplɔɪt	剥削； 利用； 开拓 / 业绩， 功绩
slap	slæp	slæp	掴，掌击，拍；啪的一声放 / 掴， 掌击， 拍
spit	spɪt	spɪt	吐唾沫，吐出 / 唾沫， 唾液
scout	skaut	skaʊt	侦察， 寻找 / 侦察员，侦察机，侦察舰；童子军
anniversary	ˌænɪ'vɜːsəri	,ænɪ'vɝsəri	周年纪念日
register	'redʒɪstə	'rɛdʒɪstɚ	登记， 注册； 指示， 自动记下； 流露； 表示， 表达； 把挂号 / 登记；登记表
restless	'restləs	'rɛstləs	焦躁不安的； 静不下来的， 运动不止的
persuasive	pə'sweɪsɪv	pɚ'swesɪv	劝诱的； 有说服力的
fleet	fliːt	flit	舰队， 船队
communicate	kə'mjuːnɪkeɪt	kə'mjunɪket	通讯； 交际， 交流； 连接， 相通； 传达， 传播； 传染
evidence	'evɪdəns	'ɛvɪdəns	根据， 证据； 证人
saddle	'sædl	'sædl	鞍，鞍状物；车座 / 给…装鞍； 使承担任务
rural	'ruərəl	'rʊrəl	农村的， 乡村的
official	ə'fɪʃl	əˈfɪʃəl; oʊˈfɪʃəl	官员的；官方的，正式的 / 官员， 行政人员， 高级人员
historical	hɪ'stɒrɪkl	hɪ'stɔrɪkl	历史的， 有关历史的
repetition	ˌrepə'tɪʃn	'rɛpə'tɪʃən	重复， 反复
fortunately	'fɔːtʃənətli	'fɔrtʃənətli	幸运地； 幸亏
acid	'æsɪd	'æsɪd	酸的， 酸性的 / 酸
transmission	trænz'mɪʃn; træns'mɪʃn	træns'mɪʃən	传播， 发射； 传送， 传递； 传染
shortage	'ʃɔːtɪdʒ	'ʃɔrtɪdʒ	不足， 缺少
discrimination	dɪsˌkrɪmɪ'neɪʃn	dɪ,skrɪmɪ'neʃən	区别， 辨别； 识别力； 差别对待， 歧视
female	'fiːmeɪl	'fimel	雌的； 女的 / 雌性动物；女子
microphone	'maɪkrəfəun	'maɪkrə'fon	扩音器， 话筒， 麦克风
swift	swɪft	swɪft	快的； 反应快的； 敏捷的
surrender	sə'rendə	sə'rɛndɚ	交出， 放弃； 投降
faint	feɪnt	fent	不清楚的，模糊的 / 晕倒，昏厥 / 昏厥
world-wide	'wɜːldwaɪd	'wə:ldwaid	遍及全球的
minister	'mɪnɪstə	'mɪnɪstɚ	部长， 大臣； 公使， 外交使节； 牧师
pose	pəuz	poz	摆姿势；假装，装腔作势 / 使摆好姿势；造成，引起；提出，陈述 / 样子， 姿势
remedy	'remədi	'rɛmədi	补救办法，纠正办法；药品；治疗法 / 补救， 纠正； 医治， 治疗
jail	dʒeɪl	dʒel	监狱，看守所 / 监禁， 拘留； 塞满； 卡住； 干扰
consent	kən'sent	kən'sɛnt	同意 / 同意，赞成
insist	ɪn'sɪst	ɪn'sɪst	坚持， 坚决认为； 坚持要求
typewriter	'taɪpraɪtə	'taɪpraɪtɚ	打字机
helpless	'helpləs	'hɛlpləs	无助的； 无能的； 无法抗拒的
respect	rɪ'spekt	rɪ'spɛkt	尊敬；尊重；问候；方面 / 尊敬； 尊重
volume	'vɒljuːm	'vɑljum	卷， 册， 书卷； 容积， 体积； 音量， 响度
retreat	rɪ'triːt	rɪ'trit	退却， 撤退； 退避， 退缩
ache	eɪk	ek	疼痛；渴望 / 疼痛
mutual	'mjuːtʃuəl	'mjutʃuəl	相互的； 共同的
shell	ʃel	ʃɛl	壳，贝壳；外壳，框架；炮弹 / 剥…的壳； 炮击
guideline	'gaɪdlaɪn	'ɡaɪdlaɪn	指导方针， 准则
loose	luːs	lus	松的； 不精确的， 不严密的； 散漫的
therefore	'ðeəfɔː	'ðɛrfɔr	因此， 所以
exchange	ɪks'tʃeɪndʒ	ɪks'tʃendʒ	交换； 交流； 兑换
hesitate	'hezɪteɪt	ˈhɛzətet	犹豫， 踌躇； 含糊； 不情愿
rifle	'raɪfl	'raɪfl	来复枪， 步枪
private	'praɪvət	ˈpraɪvɪt	私人的；秘密的；私下的；私营的 / 士兵， 列兵
baggage	'bægɪdʒ	'bæɡɪdʒ	行李
companion	kəm'pæniən	kəm'pænɪən	同伴， 共事者； 伴侣
breakdown	'breɪkdaun	'brek'daʊn	垮， 衰竭； 损坏， 故障； 倒塌
paste	peɪst	pest	糊，糨糊 / 粘， 贴
overtake	ˌəuvə'teɪk	,ovɚ'tek	追上， 超过； 突然降临于， 意外地碰上
jeans	dʒiːnz		工装裤， 牛仔裤
overnight	əʊvə'naɪt	'ovənaɪt	整夜， 通宵； 一夜间， 突然 / 一整夜的； 一夜间的， 突然的
behave	bɪ'heɪv	bɪ'hev	表现， 举止； 运转， 作出反应
stretch	stretʃ	strɛtʃ	伸展，延续；伸长，拉长；倾注全力；紧张 / 一段时间， 一段路程， 连绵的一片； 伸展， 延伸
undo	ˌʌn'duː	ʌn'du	解开， 打开； 取消， 撤销
accomplish	ə'kʌmpliʃ	ə'kɑmplɪʃ	达到； 完成
laser	'leɪzə	'lezɚ	激光
mixture	'mɪkstʃə	'mɪkstʃɚ	混合， 混合物
engine	'endʒɪn	'ɛndʒɪn	引擎， 发动机； 机车
responsible	rɪ'spɒnsəbl	rɪ'spɑnsəbl	需负责任的， 承担责任的； 有责任感的， 负责可靠的； 责任重大的， 重要的
scope	skəup	skop	范围； 余地， 机会
democratic	ˌdemə'krætɪk	'dɛmə'krætɪk	民主的， 民主政体的
medal	'medl	'mɛdl	奖牌， 奖章， 勋章
satellite	'sætəlaɪt	'sætəlaɪt	卫星， 人造卫星
bullet	'bulɪt	'bʊlɪt	枪弹， 子弹， 弹丸
recorder	rɪ'kɔːdə	rɪ'kɔrdɚ	录音机， 录像机； 记录装置， 记录仪
identify	aɪ'dentɪfaɪ	aɪ'dɛntɪfaɪ	一致 / 认出，鉴定；把…等同于
embrace	ɪm'breɪs	ɪm'bres	拥抱，怀抱 / 拥抱； 包括； 包围
nitrogen	'naɪtrədʒən	'naɪtrədʒən	氮
pour	pɔː	pɔr	灌， 倒； 倾泻
label	'leɪbl	ˈlebəl	标签；标记，符号 / 贴标签于； 把…称为
improvement	ɪm'pruːvmənt	ɪm'prʊvmənt	改进， 改善； 改进处
slippery	'slɪpəri	'slɪpəri	滑的； 狡猾的
scissors	'sɪzəz	'sɪzɚz	剪刀
significance	sɪg'nɪfɪkəns	sɪɡ'nɪfɪkəns	意义， 含义； 重要性， 重大
modify	'mɒdɪfaɪ	'mɑdɪfaɪ	更改， 修改； 修饰
horizon	hə'raɪzn	hə'raɪzn	地平线； 眼界， 见识
environment	ɪn'vaɪərənmənt	ɪn'vaɪrənmənt	环境， 外界； 围绕
airplane	'eəpleɪn	ˈɛrplen	飞机
pledge	pledʒ	plɛdʒ	保证，誓言 / 保证， 许诺
progressive	prə'gresɪv	prə'ɡrɛsɪv	前进的； 渐进的； 进行式的
reservoir	'rezəvwɑː	'rɛzɚ,vɔr	水库， 蓄水池； 储藏， 汇集
deliberate	dɪ'lɪb(ə)rət	dɪ'lɪbərət	故意的， 蓄意的； 慎重的， 深思熟虑的 / 仔细考虑， 思考
swear	sweə	swɛr	宣誓； 咒骂
atmosphere	'ætməsfɪə	'ætməsfɪr	大气， 空气； 气氛， 环境
decorate	'dekəreɪt	'dɛkəret	装饰， 装潢， 修饰
copyright	'kɒpiraɪt	'kɑpɪraɪt	版权
biotechnology	ˌbaɪəutek'nɒlədʒi	'baɪotɛk'nɑlədʒi	生物工艺学
career	kə'rɪə	kə'rɪr	生涯， 职业， 经历
occupation	ˌɒkju'peɪʃn	,ɑkju'peʃən	占领， 占据； 职业； 从事的活动， 消遣
tendency	'tendənsi	'tɛndənsi	趋向， 趋势， 倾向
release	rɪ'liːs	rɪ'lis	释放， 排放； 解除， 解脱； 放开， 松开； 发布； 发行
charter	'tʃɑːtə	'tʃɑrtɚ	包租的， 租用的 / 宪章，共同纲领；特许状，许可证；包租 / 包，租
slim	slɪm	slɪm	苗条的；薄的；少的 / 减轻体重， 变苗条
arithmetic	ə'rɪθmətɪk	ə'rɪθmətɪk	算术， 四则运算
rib	rɪb	rɪb	肋骨
faulty	'fɔːlti	'fɔlti	有错误的， 有缺点的
liberate	'lɪbəreɪt	'lɪbə'ret	解放， 释放
rid	rɪd	rɪd	使摆脱， 解除…的负担， 从…中清除
variation	ˌveəri'eɪʃn	,vɛrɪ'eʃən	变化， 变动； 变异； 变奏
moral	'mɒrəl	'mɔrəl	道德的，有道德的 / 品行； 道德规范； 寓意
defect	'diːfekt; dɪ'fekt	‘dɪfɛkt	变节， 叛变 / 缺点， 缺陷， 欠缺
reinforce	ˌriːɪn'fɔːs	,riɪn'fɔrs	增强， 加强， 增援
explode	ɪk'spləud	ɪk'splod	爆炸； 激增； 发怒 / 使爆炸
casual	'kæʒuəl	'kæʒʊəl	偶然的； 非正式的； 临时的， 不定期的； 漠不关心的， 冷淡的
decline	dɪ'klaɪn	dɪ'klaɪn	下降， 减少； 衰退， 衰落； 谢绝， 拒绝 / 下降，减少；衰退
property	'prɒpəti	'prɑpɚti	财产， 所有物； 房产； 物业； 性质， 性能
succeeding	sək'siːdɪŋ	sək'si:diŋ	以后的， 随后的
brave	breɪv	brev	勇敢的； 华丽的
similar	'sɪmələ	'sɪməlɚ	相似的， 类似的
viewpoint	'vjuːpɔɪnt	'vjupɔɪnt	观点， 看法， 见解
anyhow	'enihau	'ɛnɪ'haʊ	无论如何， 不管怎么说； 随随便便地， 杂乱无章地
specify	'spesɪfaɪ	'spɛsɪfaɪ	指定； 详细说明
whistle	'wɪsl	'wɪsl	吹口哨， 鸣笛声； 呼啸而过 / 口哨；呼啸而过
handle	'hændl	'hændl	柄，把手 / 拿， 触； 操作， 处理
forth	fɔːθ	fɔrθ	向前； 向外， 往外
tough	tʌf	tʌf	困难的， 难对付的； 坚强的， 能吃苦耐劳的； 健壮的； 坚硬的， 严格的； 老的， 硬的； 粗暴的， 充满暴力的
crossing	'krɒsɪŋ	'krɔsɪŋ	人行横道， 交叉口； 横渡
script	skrɪpt	skrɪpt	剧本， 广播稿； 书写用的字母； 笔迹， 手迹
submerge	səb'mɜːdʒ	səb'mɝdʒ	淹没， 潜入水中
system	'sɪstəm	'sɪstəm	系统； 制度， 体制； 方法， 做法； 身体
compose	kəm'pəuz	kəm'poz	组成， 构成； 创作， 为…谱曲； 使平静， 使镇静
spot	spɒt	spɑt	点，斑点；地点，处所；少量 / 认出， 发现； 玷污
roller	'rəulə	'rolɚ	滚筒， 滚轴
partial	'pɑːʃl	'pɑrʃəl	部分的； 不公平的； 偏爱的， 偏袒的
aid	eɪd	ed	帮助； 救护； 助手； 辅助手段
tone	təun	ton	腔调， 语气； 音调； 风格， 气度； 色调， 明暗
confident	'kɒnfɪdənt	'kɑnfɪdənt	确信的， 肯定的； 自信的
retain	rɪ'teɪn	rɪ'ten	保留， 保持
swell	swel	swɛl	膨胀，隆起；增长，增强，增多，扩大 / 波浪起伏； 鼓起， 隆起； 增强
skilled	skɪld	skɪld	有技能的； 熟练的； 需要技能的
local	'ləukl	ˈloʊkl	地方性的； 本地的； 局部的； 狭隘的
remind	rɪ'maɪnd	rɪ'maɪnd	提醒， 使想起
crude	kruːd	krud	简陋的， 天然的； 粗鲁的， 粗俗的
manufacturer	ˌmænju'fæktʃərə	,mænju'fæktʃərɚ	制造商； 制造厂
crew	kruː	krʊ	全体船员； 一队工作人员
valid	'vælɪd	'vælɪd	有效的； 正当的； 有根据的， 有理的
withstand	wɪð'stænd; wɪθ'stænd	wɪð'stænd	抵挡， 反抗
defeat	dɪ'fiːt	dɪ'fit	战胜， 挫败
vacuum	'vækjuəm	'vækjʊəm	用吸尘器清扫 / 真空；真空吸尘器
encourage	ɪn'kʌrɪdʒ	ɪn'kɝrɪdʒ	鼓励， 怂恿； 促进， 助长， 激发
bubble	'bʌbl	'bʌbl	冒泡； 沸腾 / 泡
era	'ɪərə	'ɪrə	时代， 年代， 纪元
yield	jiːld	jild	出产；让出，放弃；屈服，顺从；倒塌，垮掉 / 产量
electronic	ɪˌlek'trɒnɪk	ɪˌlɛkˈtrɑnɪk	电子的 / 电子学； 电子设备
vacation	və'keɪʃn; veɪ'keɪʃn	veˈkeʃən	假期， 休假
outcome	'autkʌm	'aʊt'kʌm	结果
elegant	'elɪgənt	'ɛləgənt	优美的， 文雅的， 讲究的； 简练的， 简洁的
tender	'tendə	'tɛndɚ	嫩的；脆弱的；疼痛的，一触即痛的；温柔的 / 提出 / 投标
curriculum	kə'rɪkjələm	kə'rɪkjələm	课程， 全部课程
meantime	'miːntaɪm	'min'taɪm	其间， 同时
powerful	'pauəfl	'paʊɚfl	强大的， 有力的， 有权的； 强壮的， 强健的
slip	slɪp	slɪp	滑跤，滑落，溜；下降，跌落；悄悄放进 / 疏漏， 差错
species	'spiːʃiːz	'spiʃiz	种， 类
anchor	'æŋkə	'æŋkɚ	抛锚， 停泊； 把…系住， 使固定； 担任主持人； 固定， 扎根 / 锚；给人安全感的物
preceding	prɪ'siːdɪŋ	'prisidɪŋ	在前的， 在先的， 前面的
cite	saɪt	saɪt	引用， 引证； 传唤， 传讯； 表彰， 嘉奖
logic	'lɒdʒɪk	'lɑdʒɪk	逻辑， 推理， 逻辑学
acquaintance	ə'kweɪntəns	ə'kwentəns	认识， 了解； 熟人
royal	'rɔɪəl	'rɔɪəl	王室的， 皇家的
internship	'ɪntɜːnʃɪp	'ɪntɝnʃɪp	实习生身份； 实习医师期
shed	ʃed	ʃɛd	脱落，脱去；流出，流下；发出，散发 / 棚， 小屋， 货棚
eyesight	'aɪsaɪt	'aɪsaɪt	视力， 目力
precision	prɪ'sɪʒn	prɪ'sɪʒn	精确， 精密
glove	glʌv	ɡlʌv	手套
screen	skriːn	skrin	屏幕，银幕；屏风；帘，纱窗 / 掩蔽， 遮蔽； 放映， 播放； 审查， 甄别
naked	'neɪkɪd	'nekɪd	裸体的； 无遮蔽的
trial	'traɪəl	'traɪəl	试， 试验； 审判； 讨厌的人
correspond	ˌkɒrə'spɒnd	,kɔrə'spɑnd	相符合， 相当； 通信
spur	spɜː	spɝ	刺激物 / 刺激， 鞭策， 激励
perception	pə'sepʃn	pɚ'sɛpʃən	感知， 觉察； 认识， 观念， 看法
rear	rɪə	rɪr	后部的，背后的 / 后部，背面；后方 / 抚养， 饲养； 种植
amongst	ə'mʌŋst	ə'mʌŋst	在…之中
undertake	ˌʌndə'teɪk	,ʌndɚ'tek	从事； 承担； 同意； 保证
insect	'ɪnsekt	'ɪnsɛkt	昆虫， 虫
bureau	'bjuərəu	'bjʊro	局， 司， 处， 社， 所
moist	mɔɪst	mɔɪst	湿润的， 潮湿的
cable	'keɪbl	'kebl	缆， 索， 电缆； 电报
qualify	'kwɒlɪfaɪ	ˈkwɑləˌfaɪ	胜任， 具有资格， 合格； 限定
intense	ɪn'tens	ɪn'tɛns	强烈的； 紧张的； 认真的； 热情的
pregnant	'pregnənt	'prɛɡnənt	怀孕的， 妊娠的
border	'bɔːdə	'bɔrdɚ	边，边缘，边界 / 给…加上边， 围； 邻接； 与…接壤
estate	ɪ'steɪt	ɪ'stet	土地， 住宅区， 地产； 财产， 遗产； 庄园， 种植园
applicable	'æplɪkəbl	'æplɪkəbl	能应用的； 合适的， 适当的
admission	əd'mɪʃn	əd'mɪʃən	允许进入； 承认； 入场费， 入场券
brass	brɑːs	bræs	黄铜， 黄铜器， 铜管乐器
expense	ɪk'spens	ɪk'spɛns	花费， 消费； 费用， 开支； 业务费用
rumour	'ruːmə	'ru:mə	谣传， 谣言
contemporary	kən'temprəri	kən'tɛmpərɛri	当代的；同时代的 / 同代人， 当代人
gear	gɪə	ɡɪr	齿轮，传动装置，排挡；用具，设备；衣服 / 使适应， 使适合
boundary	'baundri	'baʊndri	分界线， 边界
rob	rɒb	rɑb	抢劫， 盗窃
elderly	'eldəli	'ɛldɚli	较老的，年长的 / 到了晚年的人， 老年人
financial	faɪ'nænʃl; fə'nænʃl	faɪˈnænʃəl;fəˈnæ-	财政的， 金融的
rod	rɒd	rɑd	杆， 棒
dumb	dʌm	dʌm	哑的； 无言的； 说不出话的
respective	rɪ'spektɪv	rɪ'spɛktɪv	各自的， 各个的， 分别的
media	'miːdiə		新闻媒介， 传播媒介
favour	'feɪvə	ˈfevɚ	好感；赞同；恩惠 / 赞同； 喜爱， 偏爱； 有利于
pollute	pə'luːt	pə'lut	弄脏， 污染； 腐蚀
harden	'hɑːdn	'hɑrdn	变硬； 变得坚强
eve	iːv		前夜， 前夕， 前一刻
pronoun	'prəunaun	'pronaʊn	代词
define	dɪ'faɪn	dɪ'faɪn	给…下定义， 限定
dictate	dɪk'teɪt	'dɪktet	口授； 命令， 规定， 要求 / 命令， 指挥
construction	kən'strʌkʃn	kən'strʌkʃən	建造； 建筑物； 结构
predict	prɪ'dɪkt	prɪ'dɪkt	预言， 预告， 预测
dump	dʌmp	dʌmp	倾卸，倾倒；倾销 / 垃圾场
render	'rendə	'rɛndɚ	使得， 致使； 给予， 提供； 翻译
universal	ˌjuːnɪ'vɜːsl	'jʊnə'vɝsl	普遍的； 通用的； 全世界的
chemist	'kemɪst	'kɛmɪst	化学家， 药剂师
frontier	'frʌntɪə	frʌn'tɪr	边境， 边疆； 新领域
abroad	ə'brɔːd	ə'brɔd	到国外； 在传播， 在流传
radical	'rædɪkl	'rædɪkl	根本的，基本的；激进的，激进派的 / 激进分子
relieve	rɪ'liːv	rɪ'liv	使轻松， 使宽慰， 缓解； 使得到调剂； 接替
drawer	drɔː	drɔr	抽屉
requirement	rɪ'kwaɪəmənt	rɪ'kwaɪɚmənt	要求； 必要条件； 需要， 需要的东西
transport	træn'spɔːt; trɑːn-	'trænspɔrt	运输 / 运输， 运输工具
employment	ɪm'plɔɪmənt	ɪm'plɔɪmənt	工作； 雇用； 使用
specific	spə'sɪfɪk	spɪ'sɪfɪk	特有的；具体的，明确的 / 详情， 细节
application	ˌæplɪ'keɪʃn	ˌæpləˈkeʃən	申请， 申请书； 施用， 涂抹； 应用， 实施； 实用性
engage	ɪn'geɪdʒ	ɪn'ɡedʒ	使从事； 聘用； 吸引； 占用； 使订婚
acre	'eɪkə	'ekɚ	英亩
whisper	'wɪspə	'wɪspɚ	低声地讲 / 低语， 耳语
appetite	'æpɪtaɪt	'æpəˌtaɪt	食欲， 胃口； 欲望
semester	sɪ'mestə	səˈmɛstɚ	学期
strategy	'strætədʒi	'strætədʒi	战略， 策略
dull	dʌl	dʌl	乏味的， 单调的； 晦暗的， 阴沉的； 低沉的； 笨的； 钝的
collapse	kə'læps	kə'læps	倒坍；塌下 / 突然失败；突然瓦解
clumsy	'klʌmzi	'klʌmzi	笨拙的， 愚笨的； 粗陋的； 不得体的
territory	'terətri	'tɛrətɔri	领土， 版图； 领域
concession	kən'seʃn	kən'sɛʃən	让步， 妥协； 特许， 特许权； 承认， 认可
accurate	'ækjərət	'ækjərət	准确的， 正确无误的
maintain	meɪn'teɪn	men'ten	维持； 维修， 保养； 主张； 赡养
shift	ʃɪft	ʃɪft	移动，转移；改变，转变 / 转换， 转变； 轮班
echo	'ekəu	'ɛko	重复， 模仿； 发出回声 / 回声；反响，共鸣
erect	ɪ'rekt	ɪ'rɛkt	竖直的， 垂直的 / 建造；使竖立
bargain	'bɑːgən	ˈbɑrɡɪn	讨价还价 / 特价商品；协议，交易
professional	prə'feʃənl	prə'fɛʃənl	职业的，专业的，专门的 / 自由职业者， 专业人员
elective	ɪ'lektɪv	ɪ'lɛktɪv	选举的，有选举权的；可任意选择的 / 选修课程
accusation	ˌækju'zeɪʃn	,ækju'zeʃən	谴责； 【律】 指控
protein	'prəutiːn	'protin	蛋白质
annual	'ænjuəl	'ænjuəl	每年的，一年一次的 / 年报， 年鉴； 一年生的植物
exclusive	ɪk'skluːsɪv	ɪk'sklusɪv	奢华的，高级的；独有的，独享的；排斥的，排他的；不包括…的，不把…计算在内的 / 独家新闻
jar	dʒɑː	dʒɑr	感到不快； 震动， 摇动 / 罐子，坛子，广口瓶
poverty	'pɒvəti	'pɑvɚti	贫穷， 贫困
resort	rɪ'zɔːt	rɪ'zɔrt	求助，凭借，诉诸 / 求助， 凭借， 诉诸； 求助的对象， 采用的手段； 常去之地， 胜地
goodness	'gudnəs	ˈgʊdnɪs	天哪 / 善良， 美德， 好意
lightning	'laɪtnɪŋ	'laɪtnɪŋ	闪电， 电光
jaw	dʒɔː	dʒɔ	颌， 颚
margin	'mɑːdʒɪn	'mɑrdʒən	页边空白； 差数， 差额； 余地； 边缘
remain	rɪ'meɪn	rɪ'men	剩下，余留；保持；仍然是 / 残余； 残骸； 遗迹
amaze	ə'meɪz	ə'mez	使惊奇， 使惊愕
refine	rɪ'faɪn	rɪ'faɪn	精炼， 精制， 提纯； 使优美， 使完善
mount	maunt	maʊnt	登上；发起；安放；增加，加剧 / 山， 峰
demand	dɪ'mɑːnd	dɪ'mænd	要求， 需要； 查问
mystery	'mɪstri	ˈmɪstri	神秘； 神秘的人
atomic	ə'tɒmɪk	ə'tɑmɪk	原子的， 原子能的， 原子武器的
deposit	dɪ'pɒzɪt	dɪ'pɑzɪt	使沉淀；存放，储蓄 / 定金， 押金； 存款； 矿藏
centimetre	'sentɪmiːtə	'sɛntɪmitɚ	公分， 厘米
telescope	'telɪskəup	'tɛləˌskop	望远镜
rotten	'rɒtn	'rɑtn	腐烂的； 令人不愉快的； 糟糕的
skillful	'skɪlfl	'skɪlfəl	灵巧的， 娴熟的
flash	flæʃ	flæʃ	闪， 闪烁； 飞驰 / 闪光；闪光灯
accuse	ə'kjuːz	ə'kjuz	指责， 归咎于
housing	'hauzɪŋ	'haʊzɪŋ	房屋， 住宅； 住房建筑， 住房供给； 外壳， 外罩
devil	'devl	'dɛvl	魔鬼， 恶魔； 家伙， 人
guarantee	ˌgærən'tiː	,ɡærən'ti	保证；保证书；担保物 / 保证， 担保
recommend	ˌrekə'mend	'rɛkə'mɛnd	推荐， 举荐； 劝告， 建议； 使成为可取； 使受欢迎
acquire	ə'kwaɪə	ə'kwaɪr	取得， 获得， 学到
fertile	'fɜːtaɪl	ˈfɝtəl; (canadian) ˈfɝˌtaɪl	肥沃的； 多产的； 丰富的
automobile	'ɔːtəməbiːl	,ɔtəmə'bil	汽车， 机动车
notion	'nəuʃn	'noʃən	概念， 观念； 意图， 想法， 念头
diversity	daɪ'vɜːsəti	dɪˈvəsɪti	多样性； 差异； 不同点
helicopter	'helɪkɒptə	'hɛlɪkɑptɚ	直升机
tractor	'træktə	'træktɚ	拖拉机， 牵引车
patience	'peɪʃns	'peʃns	忍耐， 耐心
grace	greɪs	ɡres	优美，优雅；风度，魅力；宽限，缓期 / 使优美
advertisement	əd'vɜːtɪsmənt	,ædvɚ'taɪzmənt	广告， 公告， 登广告； 广告活动， 宣传
ripe	raɪp	raɪp	熟的； 时机成熟的
attribute	ə'trɪbjuːt	ə'trɪbjut	把…归因于 / 属性
mechanism	'mekənɪzəm	'mɛkənɪzəm	机械装置； 机制， 机理； 办法， 途径
detection	dɪ'tekʃn	dɪ'tɛkʃən	察觉， 发觉； 侦查， 探测
triumph	'traɪʌmf	ˈtraɪəmf	成功 / 凯旋，胜利
vice	vaɪs	vaɪs	罪恶； 恶习， 缺点； 虎钳
horror	'hɒrə	'hɔrɚ	恐怖； 憎恶； 令人恐怖的事物
poison	'pɔɪzn	'pɔɪzn	毒，毒药 / 毒害
thoughtful	'θɔːtfl	'θɔtfl	沉思的； 体贴的
gram	græm	ɡræm	克
empower	ɪm'pauə	ɪm'paʊɚ	授权于； 使能够
riot	'raɪət	'raɪət	聚众闹事 / 暴乱，骚乱；极度丰富 / 把浪费在放荡的生活上
arouse	ə'rauz	ə'raʊz	引起； 唤起， 唤醒
nest	nest	nɛst	筑巢 / 巢，窝，穴
tour	tuə	tʊr	旅行， 游历
calm	kɑːm	kɑm	静的，平静的 / 平静， 镇静
boring	'bɔːrɪŋ	'bɔrɪŋ	令人厌烦的， 乏味的， 无聊的
classic	'klæsɪk	'klæsɪk	最优秀的，典型的，标准的；传统式样的，典雅的 / 文学名著， 经典作品， 杰作； 优秀的典范； 古典文学， 古典语文研究
ownership	'əunəʃɪp	'onɚʃɪp	所有， 所有制
metric	'metrɪk	'mɛtrɪk	公制的， 米制的
absolute	'æbsəluːt	'æbsəlut	十足的， 地道的； 绝对的， 完全的； 不受任何限制的
ash	æʃ	æʃ	灰， 灰末； 骨灰
describe	dɪ'skraɪb	dɪ'skraɪb	形容； 描写； 画出
suck	sʌk	sʌk	吸， 吮， 啜； 吸收
grab	græb	ɡræb	抓取，攫取；赶紧做；抓住；抓，夺 / 抓， 夺
rub	rʌb	rʌb	擦， 摩擦
presently	'prezntli	'prɛzntli	不久， 一会儿； 现在， 目前
wealthy	'welθi	'wɛlθi	富有的， 富裕的
rug	rʌg	rʌɡ	地毯
jazz	dʒæz	dʒæz	爵士音乐， 爵士舞曲
dusk	dʌsk	dʌsk	薄暮， 黄昏； 幽暗
administration	ədˌmɪnɪ'streɪʃn	əd,mɪnɪ'streʃən	管理； 管理部门， 行政机关； 实行， 执行
occasional	ə'keɪʒənl	ə'keʒənl	偶尔的， 间或发生的
boast	bəust	bost	自夸；自豪 / 自夸，吹嘘；以拥有…而自豪 / 自吹自擂， 自夸的话
operator	'ɒpəreɪtə	'ɑpəretɚ	操作人员； 话务员， 报务员
debate	dɪ'beɪt	dɪ'bet	争论， 辩论
spacecraft	'speɪskrɑːft	'speskræft	航天器， 宇宙飞船
furniture	'fɜːnɪtʃə	'fɝnɪtʃɚ	家具
segment	'segmənt	'sɛɡmənt	部分， 片段； 瓣
stripe	straɪp	straɪp	条纹
jet	dʒet	dʒɛt	乘喷气式飞机 / 喷气式飞机；喷嘴；喷射
helpful	'helpful	'hɛlpfl	给予帮助的； 有用的
statistic	stə'tɪstɪk	stə'tɪstɪk	统计数值， 统计资料； 统计学
attractive	ə'træktɪv	ə'træktɪv	有吸引力的， 引起注意的
superb	sjʊː'pɜːb; sʊː'pɜːb	suːˈpɜːrb	极好的； 高质量的
mold	məuld	mold	霉，霉菌；模型，铸模；性格 / 用模子制作， 塑造； 使形成， 影响…的形成
engineering	ˌendʒɪ'nɪərɪŋ	'ɛndʒə'nɪrɪŋ	工程， 工程学
significant	sɪg'nɪfɪkənt	sɪɡ'nɪfɪkənt	相当数量的； 重要的， 意义重大的， 意味深长的
bold	bəuld	bold	勇敢的； 鲁莽的； 粗体的， 黑体的； 醒目的
bleed	bliːd	blid	出血， 流血； 泌脂 / 勒索…的钱
delicious	dɪ'lɪʃəs	dɪ'lɪʃəs	美味的； 芬芳的， 怡人的； 有趣的
catalogue	'kætəlɒg	'kætəlɔɡ	目录 / 为…编目录，把…列入目录中
whatever	wɒt'evə	wət'ɛvɚ	[用于否定句中以加强语气]任何； 无论什么
decrease	dɪ'kriːs	dɪ'kris	减少 / 减少
volunteer	ˌvɒlən'tɪə	,vɑlən'tɪr	自愿提供； 自愿， 志愿 / 志愿者；志愿兵
museum	mju'ziːəm	mjuˈzɪəm	博物馆
ignorance	'ɪgnərəns	'ɪɡnərəns	无知， 愚昧
senate	'senət	'sɛnət	参议院， 上院
trumpet	'trʌmpɪt	'trʌmpɪt	喇叭，小号 / 大声宣告， 鼓吹
bolt	bəult	bolt	螺栓，插销 / 闩门
string	strɪŋ	strɪŋ	连成一串； 排成一行前进 / 线，细绳；一串，一行 / 缚，扎，挂；串起，穿；使排成一列；伸展，拉直
import	ɪm'pɔːt; 'ɪm-	'ɪmpɔt	输入， 进口 / 输入， 进口； 进口商品； 意义， 重要性
occupy	'ɒkjupaɪ	'ɑkjupaɪ	占领， 占， 占有
submit	səb'mɪt	səb'mɪt	屈从， 听从， 服从 / 呈送，提交；主张，建议；使服从，使降服
mood	muːd	mud	心情， 情绪； 语气
boom	buːm	buːm	激增， 繁荣， 迅速发展； 发出隆隆声 / 激增，繁荣，迅速发展；隆隆声，嗡嗡声
absence	'æbsəns	'æbsns	缺席， 不在； 缺席的时间， 外出期； 缺乏， 不存在
attract	ə'trækt	ə'trækt	吸引， 引起…注意
edition	ɪ'dɪʃn	ɪ'dɪʃən	版， 版本， 版次
simplicity	sɪm'plɪsəti	sɪm'plɪsəti	简单， 简易； 朴素
cautious	'kɔːʃəs	'kɔʃəs	十分小心的， 谨慎的
disappear	ˌdɪsə'pɪə	'dɪsə'pɪr	不见， 失踪， 消失
summit	'sʌmɪt	'sʌmɪt	最高点， 峰顶； 最高级会议
recession	rɪ'seʃn	rɪ'sɛʃən	衰退， 衰退期
conclusion	kən'kluːʒn	kən'kluʒn	结论， 推论； 结尾； 缔结， 议定
typist	'taɪpɪst	'taɪpɪst	打字员
durable	'djuərəbl	'dʊrəbl	耐久的， 耐用的
negative	'negətɪv	'nɛɡətɪv	否定的，消极的；负的；阴性的 / 负片， 底片； 负数
impose	ɪm'pəuz	ɪm'poz	利用， 占便宜； 欺骗 / 把…强加于；征
ally	'ælaɪ	'ælaɪ	结盟， 联合 / 同盟国， 同盟者； 支持者
statement	'steɪtmənt	'stetmənt	陈述， 声明； 结算单， 报表
hence	hens	hɛns	因此， 所以； 今后
memorial	mə'mɔːriəl	məˈmɔrɪəl	纪念的，悼念的 / 纪念碑， 纪念堂， 纪念仪式
factor	'fæktə	'fæktɚ	因素； 因子； 系数
boot	buːt	but	靴子， 长筒靴； 行李箱； 解雇
pinch	pɪntʃ	pɪntʃ	捏，拧 / 撮， 微量
delivery	dɪ'lɪvəri	dɪ'lɪvəri	投递， 交付； 分娩； 讲话方式； 投递的邮件
rack	ræk	ræk	挂架，搁架 / 使痛苦， 折磨； 尽力使用
election	ɪ'lekʃn	ɪ'lɛkʃən	选举； 选择权； 当选
conquer	'kɒŋkə	'kɑŋkɚ	征服， 战胜； 破除， 克服
learned	'lɜːnɪd	'lɝnd; lɝ​nɪd	有学问的； 学术上的
substance	'sʌbstəns	'sʌbstəns	物质； 实质； 大意， 要旨； 根据， 理由
frown	fraun	fraʊn	皱眉， 蹙额
bond	bɒnd	bɑnd	黏合， 结合 / 联结，联系；公债；契约，合同
target	'tɑːgɪt	'tɑrɡɪt	目标 / 把…作为目标； 瞄准
wax	wæks	waks	蜡，蜂蜡 / 给…上蜡
grind	graɪnd	ɡraɪnd	磨， 磨快
urban	'ɜːbən	'ɝbən	城市的， 都市的； 住在都市的
furthermore	ˌfɜːðə'mɔː	,fɝðɚ'mɔr	而且， 此外
guidance	'gaɪdns	'gaɪdns	引导， 指导， 领导
risk	rɪsk	rɪsk	危险，风险；引起危险的事物 / 冒…的危险， 使遭受危险
flame	fleɪm	flem	火焰， 光辉； 热情
container	kən'teɪnə	kən'tenɚ	容器； 集装箱
leader	'liːdə	'lidɚ	领袖， 领导人， 首领
delicate	'delɪkət	ˈdɛlɪkɪt	纤细的， 易碎的； 微妙的； 精美的
discard	dɪs'kɑːd	dɪsˈkɑːrd	丢弃， 抛弃， 遗弃
fancy	'fænsi	'fænsi	昂贵的； 别致的 / 想象力，设想；爱好 / 喜欢；想象，猜想
rebel	'reb(ə)l	rɪ'bɛl	反叛， 造反； 反对， 不服从 / 反叛分子， 反对者
bounce	bauns	baʊns	弹起，反弹；颠簸 / 弹， 反弹
usage	'juːsɪdʒ; 'juːzɪdʒ	'jusɪdʒ	使用； 对待； 惯用法
tissue	'tɪʃuː; 'tɪsjuː	'tɪʃu	组织； 薄绢， 薄纸， 手巾纸
experimental	ɪkˌsperɪ'mentl	ɛk'spɛrɪ'mɛntəl	实验的， 试验的
loosen	'luːsn	'lusn	解开； 放松， 松弛
rent	rent	rɛnt	租借，租用；出租，出借 / 租金； 出租
nearby	ˌnɪə'baɪ	,nɪr'baɪ	在附近 / 附近的
carpenter	'kɑːpəntə	ˈkɑːrpəntər	木工， 木匠
cart	kɑːt	kɑrt	运货马车
modest	'mɒdɪst	'mɑdɪst	谦虚的； 适中的； 羞怯的
cast	kɑːst	kæst	投，扔，抛；浇铸 / 演员表， 全体演员； 石膏绷带； 铸型， 铸件； 投， 抛
anxious	'æŋkʃəs	'æŋkʃəs	忧虑的， 令人焦急的； 渴望的
hatred	'heɪtrɪd	'hetrɪd	憎恶， 憎恨， 仇恨
crush	krʌʃ	krʌʃ	压碎， 碾碎； 摧毁， 压垮
largely	'lɑːdʒli	'lɑrdʒli	大部分， 大量地
slice	slaɪs	slaɪs	薄片，切片；部分 / 切， 削
frost	frɒst	frɔst	结霜 / 冰冻，严寒；霜
electron	ɪ'lektrɒn	ɪ'lɛktrɑn	电子
incline	ɪn'klaɪn	ɪn'klaɪn	倾斜； 弯； 倾向于 / 斜坡
truly	'truːli	ˈtruːli	真正地； 忠实地
cash	kæʃ	kæʃ	现金，现款 / 把…兑现
counsel	'kaunsl	'kaʊnsl	律师，法律顾问；忠告，劝告 / 劝告， 提议
item	'aɪtəm	'aɪtəm	条， 条款， 一条
gene	dʒiːn	dʒin	基因
liver	'lɪvə	'lɪvɚ	肝
suicide	'suːɪsaɪd	'suɪsaɪd	自杀
violet	'vaɪələt	'vaɪələt	紫色的 / 紫罗兰
hollow	'hɒləu	'hɑlo	空的， 空洞的； 沉闷的； 虚伪的
trunk	trʌŋk	trʌŋk	树干； 大衣箱， 皮箱； 汽车后备箱； 象鼻
saving	'seɪvɪŋ	'sevɪŋ	节省， 节约； 储蓄金， 存款
rely	rɪ'laɪ	rɪ'laɪ	依靠， 依赖； 信赖， 指望
hospitalize	'hɒspɪtəlaɪz	'hɑspɪtə'laɪz	就医
slide	slaɪd	slaɪd	滑；悄悄地移动 / 滑动； 滑道， 滑面； 幻灯片
utilize	'juːtəlaɪz	'juːtəlaɪz	利用
sticky	'stɪki	'stɪki	黏性的， 胶黏的；  湿热的
prevail	prɪ'veɪl	pri'vel	流行， 盛行
waist	weɪst	west	腰， 腰部
excessive	ɪk'sesɪv	ɪkˈsɛsɪv	过多的， 极度的
flesh	fleʃ	flɛʃ	肉， 肌肉， 肉体
jungle	'dʒʌŋgl	'dʒʌŋɡl	丛林， 密林， 莽丛； 乱七八糟的一堆
portion	'pɔːʃn	'pɔrʃən	一部分，一份 / 分配， 把…分给
settle	'setl	'sɛtl	安排， 安放； 调停； 支付， 核算； 安家； 飞落， 停留； 安定
pattern	'pætn	'pætɚn	型，式样，模型 / 仿制， 使照…样子
harsh	hɑːʃ	hɑrʃ	严厉的； 粗糙的
connexion	kə'nekʃn	kə'nekʃən	connection的英式拼法
vehicle	'viːəkl	ˈviəkəl	车辆， 机动车； 传播媒介， 工具， 手段
scrape	skreɪp	skrep	刮，擦 / 刮， 擦； 刮擦声
hardship	'hɑːdʃɪp	'hɑrdʃɪp	艰难， 困苦
confuse	kən'fjuːz	kən'fjʊz	使困惑， 把…弄糊涂； 混淆， 把…混同； 混乱， 搞乱
cushion	'kuʃn	'kʊʃən	垫子， 坐垫， 靠垫
scold	skəuld	skold	责骂， 训斥
glorious	'glɔːriəs	'ɡlɔriəs; 'ɡloriəs	光荣的； 壮丽的； 令人愉快的
civilize	'sɪvəlaɪz	'sɪvəlaɪz	使文明， 使开化， 教育
physician	fɪ'zɪʃn	fɪ'zɪʃən	内科医生
architecture	'ɑːkɪtektʃə	'ɑrkə'tɛktʃɚ	建筑学； 建筑式样， 建筑风格
stress	stres	strɛs	压力；强调；重要性；应力；重音 / 强调， 着重； 重读
grip	grɪp	ɡrɪp	握紧，抓牢；吸引住 / 紧握
explore	ɪk'splɔː	ɪk'splɔr	探险， 探索； 仔细查阅， 探究
display	dɪ'spleɪ	dɪ'sple	陈列， 展览， 显示
electricity	ɪˌlek'trɪsəti	ɪ'lɛk'trɪsəti	电
climate	'klaɪmət	ˈklaɪmɪt	气候； 风土， 地带； 风气， 气氛
conductor	kən'dʌktə	kən'dʌktɚ	售票员， 列车长； 指挥； 导体
bore	bɔː	bɔr	使厌烦；钻，挖 / 令人讨厌的人
crust	krʌst	krʌst	面包皮， 硬外皮； 外壳， 地壳
disorder	dɪs'ɔːdə	dɪs'ɔrdɚ	混乱， 杂乱， 骚乱
criticize	'krɪtɪsaɪz	'krɪtə'saɪz	批评； 评论； 非难
organization	ˌɔːgənaɪ'zeɪʃn	,ɔrɡənə'zeʃən	组织， 团体， 机构
rage	reɪdʒ	redʒ	狂吹； 汹涌； 激烈进行； 发怒， 发火 / 狂怒，盛怒；风靡一时的事物，时尚
width	wɪdθ	wɪdθ	宽阔， 广阔； 宽度
dairy	'deəri	'dɛri	乳制品的 / 牛奶场；乳制品
board	bɔːd	bɔrd	搭伙； 膳宿 / 板，牌子；木板，纸板；委员会，董事会；伙食 / 上
economic	ˌiːkə'nɒmɪk	ˌikəˈnɑmɪk, ˌɛkəˈ-nɑmɪk	经济的，经济学的 / 经济学； 经济状况
stuff	stʌf	stʌf	材料，东西 / 装， 填， 塞； 让…吃饱
arrest	ə'rest	ə'rɛst	逮捕，拘留；停止，阻止；吸引 / 逮捕， 拘留， 扣留
widow	'wɪdəu	'wɪdo	寡妇
distinction	dɪ'stɪŋkʃn	dɪ'stɪŋkʃən	差别， 不同， 区分
mature	mə'tju; mə'tʃuə	mə'tʃʊr	成熟的；成年人的；深思熟虑的；到期的，应支付的 / 使成熟
navy	'neɪvi	'nevi	海军
fee	fiː	fi	费； 酬金， 赏金
section	'sekʃn	'sɛkʃən	部分， 章节； 部门， 科； 截面， 剖面
influence	'ɪnfluəns	'ɪnfluəns	影响，作用；影响力，势力；产生影响力的人 / 影响
whip	wɪp	wɪp	鞭笞；猛地移动；搅打成糊状 / 鞭子
protocol	'prəutəkɒl	'protə'kɔl	礼仪， 礼节； 草案， 议定书
whale	weɪl	wel	鲸
provoke	prə'vəuk	prə'vok	对…挑衅， 激怒； 激起， 引起
threaten	'θretn	'θrɛtn	威胁， 恐吓； 预示快要来临， 是…的征兆； 构成威胁； 可能发生
talent	'tælənt	'tælənt	天才， 才能； 人才
percentage	pə'sentɪdʒ	pɚ'sɛntɪdʒ	百分比， 百分率
negotiate	nɪ'gəuʃieɪt	nɪ'ɡoʃɪet	洽谈， 协商； 顺利通过， 成功越过； 协商， 谈判
strain	streɪn	stren	扭伤， 拉伤； 尽力； 拉紧 / 拉紧；过劳；极度紧张；张力；扭伤，拉伤；旋律；品种，家系；气质，个性特点
hunt	hʌnt	hʌnt	打猎； 搜寻； 驱逐
violin	ˌvaɪə'lɪn	,vaɪə'lɪn	小提琴
remonstrate	'remənstreɪt	rɪ'mɑnstret	抗议
package	'pækɪdʒ	'pækɪdʒ	包裹，包装；一揽子交易 / 把…打包； 包装
visible	'vɪzəbl	'vɪzəbl	可见的， 看得见的， 有形的
crisis	'kraɪsɪs	'kraɪsɪs	危机， 存亡之际； 关键阶段
rail	reɪl	rel	责骂， 抱怨 / 栏杆，横杆；铁轨，轨道；铁路
survival	sə'vaɪvl	sɚ'vaɪvl	幸存； 幸存者， 残存物
germ	dʒɜːm	dʒɝm	微生物， 细菌； 幼芽
inner	'ɪnə	'ɪnɚ	内部的； 内心的
market	'mɑːkɪt	'mɑrkɪt	市场； 股市； 行情， 销路
keen	kiːn	kin	热心的； 激烈的； 敏锐的， 敏捷的
glimpse	glɪmps	ɡlɪmps	看一眼，一瞥 / 瞥见 / 一瞥， 一看
detective	dɪ'tektɪv	dɪ'tɛktɪv	侦探， 私人侦探
transfer	træns'fɜː	træns'fɝ	搬， 转移； 调动， 转学； 转让， 过户； 乘车， 转乘
footstep	'futstep	'fʊtstɛp	脚步， 脚步声， 足迹
veteran	'vetərən	'vɛtərən	老兵， 老手
indifferent	ɪn'dɪfrənt	ɪn'dɪfrənt	冷漠的， 不积极的； 一般的， 平平的
outside	ˌaut'saɪd	,aʊt'saɪd	外部的 / 在…的外面； 向…的外面； 除…以外 / 外部，外表
nerve	nɜːv	nɝv	神经； 勇敢， 胆量
affection	ə'fekʃn	ə'fɛkʃən	感情； 爱， 爱慕
eagle	'iːgl	'igl	鹰
cruise	kruːz	krʊz	航游，巡航；缓慢巡行 / 航游， 游弋
elementary	ˌelɪ'mentri	,ɛlɪ'mɛntri	基本的， 初级的
topic	'tɒpɪk	'tɑpɪk	题目， 论题， 话题
solemn	'sɒləm	'sɑləm	庄严的， 隆重的； 严肃的
perceive	pə'siːv	pɚ'siv	感知， 感觉， 察觉； 认识到， 意识到； 理解
omit	ə'mɪt	ə'mɪt	省略； 遗漏
embarrass	ɪm'bærəs	ɪm'bærəs	使窘迫， 使为难
option	'ɒpʃn	'ɑpʃən	选择， 选择权， 选择自由； 选择的事物或人， 选课
erroneous	ɪ'rəuniəs	ɪ'ronɪəs	错误的， 不正确的
raid	reɪd	red	袭击； 突入查抄， 突入搜捕； 劫掠
politics	'pɒlətɪks	'pɑlətɪks	政治， 政治学； 政纲， 政见
acute	ə'kjuːt	ə'kjut	严重的； 急性的； 灵敏的， 敏锐的； 精明的
limitation	ˌlɪmɪ'teɪʃn	,lɪmɪ'teʃən	限制， 限度； 局限
sponsor	'spɒnsə	'spɑnsɚ	发起者 / 发起； 资助， 赞助； 支持
kindergarten	'kɪndəgɑːtn	'kɪndɚɡɑrtn	幼儿园
unexpected	ˌʌnɪk'spektɪd	'ʌnɪk'spɛktɪd	想不到的， 意外的
crucial	'kruːʃl	'krʊʃəl	至关重要的， 决定性的
contribute	kən'trɪbjuːt	kən'trɪbjut	捐献， 捐款； 投稿
faith	feɪθ	feθ	信任； 信心； 信仰， 信条； 忠诚
generator	'dʒenəreɪtə	'dʒɛnəretɚ	发电机； 发生器
insert	ɪn'sɜːt	'ɪnsɝt	插入， 嵌入； 登载
remark	rɪ'mɑːk	rɪ'mɑrk	说；评论说 / 话语； 谈论， 评论
forbid	fə'bɪd	fɚ'bɪd	禁止， 不许， 阻止
microscope	'maɪkrəskəup	'maɪkrəskop	显微镜
necessarily	'nesəsərəli; ˌnesə'serəli	,nɛsə'sɛrəli	必要地； 必然
highlight	'haɪlaɪt	'haɪlaɪt	强调，突出，使显著 / 最精彩的部分； 最重要的事件
candidate	'kændɪdeɪt; 'kændɪdət	ˈkændɪˌdet, -dɪt	候选人； 投考者， 申请求职者
billion	'bɪljən	'bɪljən	十亿
parallel	'pærəlel	'pærəlɛl	平行的；类似的；并列的，并联的 / 可相比拟的事物；相似处；平行线，平行面；纬线 / 与…平行； 与…相似， 与…相当， 比得上
reject	rɪ'dʒekt	rɪ'dʒɛkt	拒绝； 拒纳， 退回 / 次品
patient	'peɪʃnt	ˈpeʃənt	忍耐的，有耐心的 / 病人
cashier	kæ'ʃɪə	kæ'ʃɪr	出纳
sheer	ʃɪə	ʃɪr	垂直地，陡峭地 / 急转向， 偏离 / 完全的，十足的；陡峭的，垂直的；极薄的，透明的
miracle	'mɪrəkl	'mɪrəkl	奇迹， 令人惊奇的人
profit	'prɒfɪt	'prɑfɪt	受益 / 益处；利润，收益 / 有益于，有利于
original	ə'rɪdʒənl	ə'rɪdʒənl	最初的；新颖的；原版的 / 原件， 原作
wit	wɪt	wɪt	风趣； 妙语； 智力， 才智， 智能
handful	'hændful	'hænd,fʊl	一把， 少数， 一小撮
assignment	ə'saɪnmənt	ə'saɪnmənt	任务， 指定的作业； 分配， 指派
nylon	'naɪlɒn	'naɪlɑn	尼龙
yawn	jɔːn	jɔn	打呵欠 / 呵欠
electric	ɪ'lektrɪk	ɪ'lɛktrɪk	电的， 电动的
terminal	'tɜːmɪnl	tɝ​mənl	晚期的，不治的；末端的，终点的，极限的 / 终点； 终端； 接线端
kingdom	'kɪŋdəm	'kɪŋdəm	王国； 领域； 界
differ	'dɪfə	'dɪfɚ	不同， 相异； 发生分歧
various	'veəriəs	'vɛrɪəs	各种各样的， 不同的
latter	'lætə	'lætɚ	后者的； 后一半的
depression	dɪ'preʃn	dɪ'prɛʃən	抑郁， 沮丧； 不景气， 萧条； 洼地， 凹陷
reduction	rɪ'dʌkʃn	rɪ'dʌkʃən	减少， 缩小； 下降， 降低
extent	ɪk'stent	ɪk'stɛnt	广度； 范围； 程度
equivalent	ɪ'kwɪvələnt	ɪ'kwɪvələnt	相等的，等量的 / 相等物， 等价物
gaol	dʒeɪl	dʒeɪl	监禁 / 监狱
conversely	'kɒnvɜːsli	'kɑnvɝsli	相反
sauce	sɔːs	sɔs	调味汁， 作料
ban	bæn	bæn	取缔，查禁；禁止 / 禁止， 禁令
fascinate	'fæsɪneɪt	'fæsə'net	有吸引力， 迷人 / 迷住，强烈吸引
suffer	'sʌfə	'sʌfɚ	遭受， 忍受， 容许； 受痛苦， 受损
diplomatic	ˌdɪplə'mætɪk	,dɪplə'mætɪk	外交的， 从事外交的； 策略的， 有手腕的
bat	bæt	bæt	蝙蝠； 球棒， 球拍
neighbourhood	'neɪbəhud	nebɚˌhʊd	四邻； 附近； 接近
draft	drɑːft	dræft	草稿；汇票；征兵；通风 / 起草； 征募
complex	'kɒmpleks	ˈkɑmplɛks;kəmˈplɛks	由许多部分组成的， 复合的； 复杂的， 难懂的
rank	ræŋk	ræŋk	给…评定等级； 列入， 占特定等级 / 军衔，职衔；地位，社会阶层；排，行列
assumption	ə'sʌmpʃn	ə'sʌmpʃən	假定， 臆断； 担任， 承担
pension	'penʃn	'pɛnʃən	养老金，抚恤金 / 发给…养老金
giant	'dʒaɪənt	'dʒaɪənt	巨大的 / 巨人，巨物；才智超群的人
fluid	'fluːɪd	'fluɪd	流动的 / 流体，液体
bay	beɪ	be	湾； 分隔间
outlet	'autlet	'aʊtlɛt	出口， 出路； 发泄途径
neglect	nɪ'glekt	nɪ'glɛkt	疏于照料；疏忽 / 疏忽
addition	ə'dɪʃn	ə'dɪʃən	加， 加法； 附加物
gang	gæŋ	ɡæŋ	聚集， 结成一伙 / 一帮，一伙
shrink	ʃrɪŋk	ʃrɪŋk	起皱； 收缩； 退缩， 畏缩
ancestor	'ænsestə	'ænsɛstɚ	祖宗， 祖先； 原型； 先驱
textile	'tekstaɪl	'tɛkstaɪl	纺织的 / 纺织品；纺织业
former	'fɔːmə	'fɔrmɚ	在前的 / 前者
panic	'pænɪk	'pænɪk	恐慌， 惊慌失措 / 恐慌，惊慌，慌乱
extend	ɪk'stend	ɪk'stɛnd	延长， 扩大； 提供， 给予； 伸展， 达到
fold	fəuld	fold	折叠，合拢 / 褶， 折叠的部分
plastic	'plæstik	'plæstɪk	塑料的；可塑的 / 塑料， 塑料制品； 信用卡
globe	gləub	ɡlob	地球， 世界； 地球仪； 球体
chemical	'kemɪkl	'kɛmɪkl	化学的 / 化学制品
interpretation	ɪnˌtɜːprɪ'teɪʃn	ɪn'tɝprɪ'teʃən	解释； 口译； 艺术处理
ax	æks	æks	斧子
intermediate	ˌɪntə'miːdiət	,ɪntɚ'midɪət	中间的； 中级的
folk	fəuk	fok	人们； 家属， 亲属； 大伙儿， 各位
consideration	kənˌsɪdə'reɪʃn	kən,sɪdə'reʃən	考虑， 思考， 要考虑的事； 体贴， 关心
competitive	kəm'petətɪv	kəm'pɛtətɪv	竞争的， 比赛的； 好竞争的， 求胜心切的； 有竞争力的
enquiry	ɪn'kwaɪəri	ɛnˈkwaɪri, ˈɛnkwəri	询问
applause	ə'plɔːz	ə'plɔz	鼓掌， 掌声
frank	fræŋk	fræŋk	坦白的， 直率的
abuse	ə'bjuːz	ə'bjus	滥用； 虐待， 伤害； 辱骂， 毁谤 / 滥用； 虐待， 伤害； 辱骂， 毁谤
prove	pruːv	pruv	证实， 证明； 结果是
scheme	skiːm	skim	密谋， 策划 / 计划，方案；阴谋
affect	ə'fekt	ə'fɛkt	影响； 感动
deaf	def	dɛf	聋的； 不愿听的
admire	əd'maɪə	ədˈmaɪr	钦佩， 羡慕； 赞赏， 称赞， 夸奖
consequently	'kɒnsɪkwəntli	'kɑnsəkwɛntli	因此， 因而， 所以
virus	'vaɪərəs	'vaɪrəs	病毒； 病毒性疾病， 病毒病
drain	dreɪn	dren	排去，放水 / 耗竭； 排水沟， 排水管
isolate	'aɪsəleɪt	aɪslˌet	使隔离， 使孤立
sailor	'seɪlə	'selɚ	水手， 海员
amuse	ə'mjuːz	ə'mjuz	逗…乐， 给…娱乐
inward	'ɪnwəd	'ɪnwɚd	向内 / 里面的；内心的
responsibility	rɪˌspɒnsə'bɪləti	rɪˌspɑːnsəˈbɪləti	责任， 责任心； 职责， 义务
enquire	ɪn'kwaɪə	ɪn'kwaɪr	询问
civil	'sɪvl	'sɪvl	公民的； 文职的； 民用的； 民事的， 民法的； 文明的
popularity	ˌpɒpju'lærəti	,pɑpju'lærəti	普及， 流行； 声望
subsequent	'sʌbsɪkwənt	'sʌbsɪkwənt	随后的， 后来的
indicate	'ɪndɪkeɪt	'ɪndɪket	标示， 表示， 表明
scarcely	'skeəsli	'skɛrsli	几乎不， 简直不； 决不； 刚刚， 才
panel	'pænl	'pænl	专门小组； 面， 板； 控制板， 仪表盘
outstanding	ˌaut'stændɪŋ	'aʊt'stændɪŋ	突出的， 杰出的； 未解决的； 未偿付的
charge	tʃɑːdʒ	tʃɑrdʒ	索价；控告；充电，充满；向前冲 / 费用； 管理； 控告， 指责； 电荷， 充电
sew	səu	so	缝制， 缝纫
oval	'əuvl	'ovl	椭圆形的 / 椭圆形
column	'kɒləm	'kɑləm	柱， 支柱， 圆柱； 纵队； 栏， 专栏
procedure	prə'siːdʒə	prə'sidʒɚ	程序， 手续， 步骤
sample	'sɑːmpl	'sæmpl	样品，试样，样本 / 从…抽样； 品尝， 体验
integrate	'ɪntɪgreɪt	'ɪntɪɡret	成为一体， 合并
survivor	sə'vaɪvə	sɚ'vaɪvɚ	生还者； 残存物
applicant	'æplɪkənt	'æplɪkənt	申请人
tropical	'trɒpɪkl	'trɑpɪkl	热带的； 炎热的
partner	'pɑːtnə	'pɑrtnɚ	做…的搭档 / 伙伴，合伙人，搭档，配偶
plunge	plʌndʒ	plʌndʒ	纵身投入， 猛冲； 猛跌
diagnose	'daɪəgnəuz	,daɪəɡ'nos	诊断
somewhat	'sʌmhwɒt	'sʌmwʌt	有点儿 / 一点儿
earnest	'ɜːnɪst		认真的， 诚恳的
spider	'spaɪdə	'spaɪdɚ	蜘蛛
interview	'ɪntəvjuː	'ɪntɚvju	接见， 会见； 面谈， 面试； 采访
essential	ɪ'senʃl	ɪ'sɛnʃl	必要的；本质的 / 要素； 必需品
clarify	'klærəfaɪ	'klærəfaɪ	澄清， 阐明
furnace	'fɜːnɪs	'fɝnɪs	炉子， 熔炉， 鼓风炉
ditch	dɪtʃ	dɪtʃ	沟， 沟渠， 渠道
deck	dek	dɛk	甲板， 舱面； 层面
scare	skeə	skɛr	吓， 使害怕； 受惊吓， 感到害怕 / 惊恐，恐慌
thunder	'θʌndə	'θʌndɚ	打雷， 轰隆响； 大声喊， 吼 / 雷，雷声；擂鼓般的响声，轰隆声
observe	əb'zɜːv	əb'zɝv	注意到， 观察； 评说； 遵守
humorous	'hjuːmərəs	'hjumərəs	幽默的， 诙谐的
furnish	'fɜːnɪʃ	'fɝnɪʃ	供应， 提供； 装备
bet	bet	bɛt	打赌；敢说，确信 / 打赌； 赌金， 赌注
contact	'kɒntækt	'kɑntækt	接触；联系，交往 / 与…接触， 与…取得联系
rare	reə	rɛr	稀有的， 冷僻的； 珍奇的； 出类拔萃的； 稀薄的； 煎得嫩的
discharge	dɪs'tʃɑːdʒ	dɪs'tʃɑrdʒ	释放， 排出； 卸货 / 释放， 放电
exclude	ɪk'skluːd	ɪk'sklʊd	把…排除在外
scary	'skeəri	'skɛri	引起惊慌的
criticism	'krɪtɪsɪzəm	'krɪtə'sɪzəm	批评， 批判； 评论， 评论文章
utmost	'ʌtməust	'ʌt'most	最远的 / 极限
image	'ɪmɪdʒ	'ɪmɪdʒ	像； 形象； 映像； 形象的描述
consultancy	kən'sʌltənsi	kən'sʌltənsi	咨询公司
ribbon	'rɪbən	'rɪbən	缎带， 丝带； 色带
garbage	'gɑːbɪdʒ	'ɡɑrbɪdʒ	垃圾， 废物； 废话； 无用的资料
complain	kəm'pleɪn	kəm'plen	抱怨， 诉苦； 控告， 投诉
mainland	'meɪnlænd	'menlænd	大陆
homogeneous	ˌhɒmə'dʒiːniəs	,homə'dʒinɪəs	同种类的， 同性质的， 有相同特征的
anxiety	æŋ'zaɪəti	æŋ'zaɪəti	焦虑， 忧虑； 渴望， 热望
temptation	temp'teɪʃn	tɛmp'teʃən	诱惑， 引诱
adjust	ə'dʒʌst	ə'dʒʌst	调整， 调节， 校正
popularize	'pɒpjələraɪz	'pɑpjələraɪz	普及
burst	bɜːst	bɝst	爆裂，爆炸；挤满；突然打开；突然发作 / 使爆炸；突然打开 / 爆炸
vigorous	'vɪgərəs	'vɪɡərəs	朝气蓬勃的； 有力的， 用力的
debt	det	dɛt	债， 债务， 欠债
refrigerator	rɪ'frɪdʒəreɪtə	rɪ'frɪdʒəretɚ	冰箱， 冷藏库
necessity	nə'sesəti	nə'sɛsəti	必需品； 必要性， 需要
fog	fɒg	fɔɡ	雾， 烟雾， 尘雾
frame	freɪm	frem	框架，框子，构架 / 给…镶框； 陷害， 诬告； 制定； 表达
lucky	'lʌki	'lʌki	幸运的， 侥幸的； 吉利的
origin	'ɒrɪdʒɪn	'ɔrɪdʒɪn	起源， 起因； 出身， 血统
industrialize	ɪn'dʌstriəlaɪz	ɪn'dʌstrɪəlaɪz	工业化
clash	klæʃ	klæʃ	发生冲突；不协调；砰地相撞，发出刺耳的撞击声 / 冲突； 不协调； 刺耳的撞击声
compel	kəm'pel	kəm'pɛl	强迫， 迫使屈服
capable	'keɪpəbl	'kepəbl	有能力的， 有才能的
depress	dɪ'pres	dɪ'prɛs	使沮丧； 使不景气； 削弱， 抑制
parade	pə'reɪd	pə'red	游行， 列队前进； 招摇而行 / 游行；检阅
burden	'bɜːdn	'bɝdn	重担，精神负担 / 加重压于， 烦扰； 负担， 装载
precaution	prɪ'kɔːʃn	prɪ'kɔʃən	预防； 防备， 警惕
lemon	'lemən	'lɛmən	柠檬； 柠檬树； 柠檬黄， 淡黄色
personality	ˌpɜːsə'næləti	,pɝsə'næləti	人格， 个性； 人物， 名人
plot	plɒt	plɑt	密谋， 计划； 绘制…的平面图， 在图上标绘…的位置 / 故事情节；计划，密谋；小块土地
sanction	'sæŋkʃn	'sæŋkʃən	批准，认可 / 批准， 认可； 约束因素， 约束力；  国际制裁
rate	reɪt	ret	被评价； 被列入特定级别 / 速度，速率；比率；价格，费用；等级 / 评估；给…定级，把…列为；值得，应得
alert	ə'lɜːt	ə'lɝt	警觉的，留神的，注意的 / 使认识到，使意识到 / 警戒， 戒备； 警报
await	ə'weɪt	ə'wet	等候； 期待； 将降临到…身上
sin	sɪn	sɪn	犯戒律， 犯过失 / 罪，罪孽
client	'klaɪənt	'klaɪənt	委托人， 当事人， 顾客
prosperity	prɒ'sperəti	prɑ'spɛrəti	繁荣， 兴旺
divide	dɪ'vaɪd	dɪ'vaɪd	分，分开；分配，分享；除；产生分歧 / 分歧； 分界线， 分水岭
contrary	'kɒntrəri	'kɑntrɛri	相反的 / 相反
lump	lʌmp	lʌmp	结块； 将…归并在一起 / 块，肿块
digital	'dɪdʒɪtl	'dɪdʒɪtl	数字的， 数位的
brilliant	'brɪliənt	'brɪljənt	光辉的； 卓越的
historic	hɪ'stɒrɪk	hɪ'stɔrɪk	历史上著名的， 具有重大历史意义的
oven	'ʌvn	ˈʌvən	炉， 烤箱
bound	baund	baʊnd	跳跃；弹回，反跃 / 一定的；有义务的 / 跳跃；弹回，反跃；成为…的界限，给…划界 / 跳跃； 界限， 限制
counter	'kauntə	'kaʊntɚ	柜台； 计数器； 筹码
rhythm	'rɪðəm	'rɪðəm	韵律， 节奏
stroke	strəuk	strok	中风；一举，一次努力；划桨，划水；击，敲；报时的钟声；笔画，一笔；抚摸 / 抚摸
breed	briːd	brid	繁殖； 养育， 培育； 酿成， 产生 / 品种
management	'mænɪdʒmənt	'mænɪdʒmənt	管理； 处理； 管理部门； 管理人员
publish	'pʌblɪʃ	'pʌblɪʃ	公布， 发表； 出版， 刊印
realm	relm	rɛlm	界， 领域， 范围； 王国， 国度
correspondent	ˌkɒrə'spɒndənt	,kɔrə'spɑndənt	通讯员， 记者
avoid	ə'vɔɪd	ə'vɔɪd	避免， 躲开； 撤销
renew	rɪ'njuː	rɪ'nʊ	重新开始， 继续； 更新； 恢复； 延长有效期
bid	bɪd	bɪd	企图，努力；喊价，出价，投标 / 喊价， 投标， 出； 祝， 表示； 命令
prompt	prɒmpt	prɑmpt	敏捷的，及时的 / 促使，推动；提示 / 提示台词， 提示
astonish	ə'stɒnɪʃ	ə'stɑnɪʃ	使惊讶， 使吃惊
comprehensive	ˌkɒmprɪ'hensɪv	ˌkɑːmprɪˈhensɪv	广泛的， 综合的； 理解的
tunnel	'tʌnl	'tʌnl	挖， 开 / 隧道，坑道，地道
withdraw	wɪð'drɔː; wɪθ'drɔː	wɪð'drɔ	收回， 撤回； 撤退
assign	ə'saɪn	ə'saɪn	指派， 分配， 布置； 指定
elaborate	ɪ'læb(ə)rət	ɪ'læbəret	复杂的； 精心制作的 / 详述， 详细制订
feather	'feðə	'fɛðɚ	羽毛， 翎毛
corridor	'kɒrɪdɔː	'kɔrɪdɔr	走廊， 回廊， 通路
decade	'dekeɪd	'dɛked	十年， 十年期
expert	'ekspɜːt	'ɛkspɝt; (for adj., also) ɛksˈpɝt ; ɪkˈspɝt	熟练的 / 专家
select	sɪ'lekt	sə'lɛkt	精选的， 挑选出来的； 优等的， 第一流的 / 选择，挑选
fulfill	ful'fɪl	ful'fil	履行， 实现， 完成； 满足， 使满意
crowd	kraud	kraʊd	聚集； 挤满； 挤； 推 / 群，一批
congress	'kɒŋgres	'kɑŋɡrəs	代表大会； [C-]国会， 议会
advanced	əd'vɑːnst	əd'vænst	先进的； 高级的； 年迈的； 后阶段的
mechanical	mə'kænɪkl	mɪ'kænɪkəl	机械的， 机械制造的； 机械学的， 力学的； 呆板的
recommendation	ˌrekəmen'deɪʃn	,rɛkəmɛn'deʃən	推荐， 推荐信； 建议； 优点， 可取之处
welfare	'welfeə	'wɛl'fɛr	幸福； 福利， 福利救济
flourish	'flʌrɪʃ	ˈflɜːrɪʃ	繁荣，茂盛，兴旺 / 挥动
output	'autput	'aʊtpʊt	产量；输出；输出功率 / 输出
fatigue	fə'tiːg	fə'tig	疲劳 / 疲劳，劳累
striking	'straɪkɪŋ	'straɪkɪŋ	显著的， 突出的； 惹人注目的， 容貌出众的
vessel	'vesl	'vɛsl	容器； 船； 飞船； 管
majority	mə'dʒɒrəti	mə'dʒɔrəti	多数， 大多数
drag	dræg	dræg	拖，拉；迫使，硬拉；拖着脚步走 / 累赘； 一吸， 一抽
crown	kraun	kraʊn	王冠， 冕
likely	'laɪkli	'laɪkli	可能 / 可能的；适合的
inquire	ɪn'kwaɪə	ɪn'kwaɪr	打听， 询问； 调查
gymnasium	dʒɪm'neɪziəm	dʒɪm'nezɪəm	体育馆， 健身房
issue	'ɪʃu:	'ɪʃu	发行， 分发， 发出 / 问题；发行，分发
vain	veɪn	ven	徒劳的； 自负的
lower	'ləuə	'loɚ	较低的；下面的 / 放下， 降低
index	'ɪndeks	'ɪndɛks	索引； 指数， 指标
fry	fraɪ	fraɪ	油煎， 油炸， 油炒
youngster	'jʌŋstə	'jʌŋstɚ	青年， 年轻人， 孩子
odd	ɒd	ɑd	奇特的； 临时的； 奇数的； 单只的； 剩余的， 挂零的
lung	lʌŋ	lʌŋ	肺
conservation	ˌkɒnsə'veɪʃn	,kɑnsɚ'veʃən	保存； 保护； 守恒
distraction	dɪ'strækʃn	dɪ'strækʃən	分心的事； 心烦意乱； 精神错乱； 娱乐， 消遣
supplement	'sʌplɪm(ə)nt	'sʌplɪmənt	增补， 补充； 增刊， 副刊 / 增补， 补充
contrast	'kɒntrɑːst	'kɑntræst	形成对比， 对比之下显出区别 / 对比， 对照； 反差 / 对比，对照
paragraph	'pærəgrɑːf	'pærəɡræf	段， 节
judgement	'dʒʌdʒmənt	'dʒʌdʒmənt	意见； 审判； 判断
proportion	prə'pɔːʃn	prə'pɔrʃən	比例； 部分， 份儿； 均衡， 相称
widen	'waɪdn	'waɪdn	加宽， 变宽
crystal	'krɪstl	'krɪstl	水晶， 结晶体， 晶粒
occurrence	ə'kʌrəns	ə'kʌrəns	发生， 出现； 发生的事件
inflation	ɪn'fleɪʃn	ɪn'fleʃən	通货膨胀； 膨胀
thinking	'θɪŋkɪŋ	'θɪŋkɪŋ	深思的， 有理性的 / 想法，意见，见解
cycle	'saɪkl	'saɪkl	循环（周期） / 骑自行车
disposal	dɪ'spəuzl	dɪ'spozl	丢掉， 销毁； 处理； 排列， 布置
settlement	'setlmənt	'sɛtlmənt	解决； 协议； 居留地
delegate	ˈdɛlɪˌɡeɪt; -ɡɪt; (for v.,) ˈdɛlɪˌɡeɪt	ˈdɛləgɪt; (for v.,) ˈdɛləˌgeɪt	代表， 代表团成员 / 委派…为代表； 授 ， 把…委托给
literature	'lɪtrətʃə	lɪtərəˌtʃʊr	文学， 文学作品； 文献， 图书资料
sphere	sfɪə	sfɪr	球， 球体； 范围
inquiry	ɪn'kwaɪəri	ɪn'kwaɪri; 'ɪn,kwaɪri; 'ɪnkwəri; 'ɪŋkwaɪri	询问， 打听； 调查
prejudice	'predʒudɪs	'prɛdʒədɪs	偏见，成见 / 使有偏见； 对…不利， 损害
dissolve	dɪ'zɒlv	dɪ'zɑlv	溶解； 解散； 消失， 减弱； 结束
digest	daɪ'dʒest; dɪ-	daɪ'dʒɛst	消化； 领会 / 文摘； 摘要
angle	'æŋgl	'æŋɡl	角， 角度； 观点， 立场
immigrant	'ɪmɪgrənt	'ɪmɪɡrənt	移民， 侨民
tradition	trə'dɪʃn	trə'dɪʃən	传统， 惯例
ability	ə'bɪləti	əˈbɪlətɪ	能力， 本领； 才能， 才智
urgent	'ɜːdʒənt	'ɝdʒənt	紧急的， 急迫的
belief	bɪ'liːf	bɪ'lif	信任， 相信； 信念
bundle	'bʌndl	'bʌndl	捆，包，束；包袱 / 收集， 归拢； 把…塞入
suggestion	sə'dʒestʃən	sə'dʒɛstʃən	建议， 意见； 细微的迹象； 暗示
systematic	ˌsɪstə'mætɪk(l)	'sɪstə'mætɪk	有系统的， 有计划的
cupboard	'kʌbəd	'kʌbɚd	柜橱；  碗碟橱， 食橱
generally	'dʒenərəli	'dʒɛnrəli	一般地， 通常地； 普遍地
bacon	'beɪkən	'bekən	咸肉
likewise	'laɪkwaɪz	'laɪkwaɪz	同样地； 也， 又
slender	'slendə(r)	'slɛndɚ	细长的， 苗条的； 微薄的， 不足的
troublesome	'trʌblsəm	'trʌblsəm	令人烦恼的， 麻烦的
instruction	ɪn'strʌkʃn	ɪn'strʌkʃən	命令， 指示； 用法说明； 教学， 教导
oral	'ɔːrəl	'ɔrəl	口头的； 口的
married	'mærid	'mærɪd	已婚的； 婚姻的
transaction	træn'zækʃn	træn'zækʃən	办理， 处理； 交易， 业务； 会报， 学报
conscious	'kɒnʃəs	'kɑnʃəs	意识到的， 自觉的； 神志清醒的； 有意的， 存心的
fur	fɜː	fɝ	软毛， 毛皮， 裘皮； 毛皮衣服
auto	'ɔːtəu	'ɔto	汽车
sigh	saɪ	saɪ	叹气， 叹息 / 叹息
constant	'kɒnstənt	'kɑnstənt	经常的，不断的，连续发生的；永恒的；忠实的，忠诚的 / 常数， 恒量
pants	pænts	pænts	长裤， 便裤； 内裤
mislead	ˌmɪs'liːd	'mɪs'lid	给…错误印象， 使误解； 把…带错路； 使误入歧途
split	splɪt	splɪt	分裂，分离；被撕裂，裂开；分担，分享 / 裂口
orchestra	'ɔːkɪstrə	'ɔrkɪstrə	管弦乐队
publication	ˌpʌblɪ'keɪʃn	,pʌblɪ'keʃən	出版， 发行； 公布， 发表
sufficient	sə'fɪʃnt	səˈfɪʃənt	足够的， 充分的
claim	kleɪm	klem	声称，主张；对…提出要求，索取；以…为其成果；需要，值得 / 要求， 认领， 索赔； 声称； 断言
antique	æn'tiːk	æn'tik	古时的， 过时的 / 古物，古董
sow	səu	so	播， 播种
widespread	'waɪdspred	ˈwʌɪdsprɛd	分布广的， 普遍的
petroleum	pə'trəuliəm	pə'trolɪəm	石油
communication	kəˌmjuːnɪ'keɪʃn	kə,mjunɪ'keʃən	通讯， 交流， 交际； 通信工具， 交通联系
directly	dɪ'rektli; daɪ'rektli	dəˈrektli	直接地； 正好地， 截然； 立即
tolerance	'tɒlərəns	'tɑlərəns	忍受， 容忍， 忍耐力； 公差
kneel	niːl	nil	跪， 跪下， 跪着
porter	'pɔːtə	'pɔrtɚ	搬运工人； 看门人， 大楼管理员
fasten	'fɑːsn	'fæsən	扎牢， 扣住
contest	'kɒntest	kən'tɛst	竞赛， 争夺 / 争夺， 与…竞争； 对…提出质疑， 辩驳
author	'ɔːθə	'ɔθɚ	著作家， 作者
dirt	dɜːt	dɝt	灰尘， 土； 污物， 污垢
astrophysics	ˌæstrəu'fɪzɪks	,æstro'fɪzɪks	天体物理学
greenhouse	'griːnhaus	'ɡrinhaʊs	温室， 暖房
preserve	prɪ'zɜːv	prɪ'zɝv	保护， 维持； 保存； 腌制
plus	plʌs	plʌs	表示加的；正的 / 加，加上 / 加号， 正号
establish	ɪ'stæblɪʃ	ɪˈstæblɪʃ	建立， 设立； 确立； 证实
expansion	ɪk'spænʃn	ɪk'spænʃən	扩大， 扩充， 扩张， 膨胀
relevant	'reləvənt	'rɛləvənt	有关的， 切题的
entry	'entri	'ɛntri	入口处； 登记； 进入； 参赛者名单； 条目
license	'laɪsns	'laɪsns	许可，执照 / 准许
synthetic	sɪn'θetɪk	sɪn'θɛtɪk	综合的， 合成的； 虚假的
headquarters	ˌhed'kwɔːtəz	'hɛdkwɔrtɚz	司令部， 总部
expand	ɪk'spænd	ɪk'spænd	扩大， 使膨胀
gaze	geɪz	ɡeɪz	凝视， 盯， 注视
essay	'eseɪ	'ɛse	短文， 散文， 小品文
survey	ˈsəːveɪ; (for v.) səˈveɪ	ˈsɝˌve; (for v.) sɝˈve	俯瞰； 检查； 测量 / 调查， 勘察； 测量， 勘测； 全面审视， 概括论述
plug	plʌg	plʌɡ	插头，插座；塞子，栓 / 把…塞住， 用…塞住
bunch	bʌntʃ	bʌntʃ	集中， 挤在一起； 形成一束 / 群，伙；束，串，捆 / 使成一束
thermometer	θə'mɒmɪtə	θɚ'mɑmɪtɚ	温度计， 寒暑表
tense	tens	tɛns	拉紧的；紧张的 / 拉紧， 绷紧 / 时态
postpone	pə'spəun	po'spon	延迟， 延期
bride	braɪd	braɪd	新娘
favourable	'feɪvərəbl	'feivərəbl	有利的， 赞成的； 顺利的
hammer	'hæmə	'hæmɚ	锤击 / 锤，榔头
candy	'kændi	ˈkændɪ	糖果
seal	siːl	sil	封铅，封条；印，图章；海豹 / 封
mental	'mentl	'mɛntl	心理的， 精神的， 思想上的； 精神病的； 智力的
decent	'diːsnt	'disnt	像样的， 过得去的， 体面的； 宽厚的， 大方的； 正派的； 合乎礼仪的， 得体的
storage	'stɔːrɪdʒ	'stɔrɪdʒ	贮藏； 贮藏量
investigate	ɪn'vestɪgeɪt	ɪn'vɛstɪɡet	调查， 研究
racial	'reɪʃl	'reʃl	种族的， 人种的
switch	swɪtʃ	swɪtʃ	转换， 改变 / 开关，电闸；转换，改变
niece	niːs	nis	侄女， 外甥女
considerable	kən'sɪdərəbl	kən'sɪdərəbl	相当大的； 重要的
auxiliary	ɔːg'zɪliəri	ɔːɡ'zɪlɪəri	辅助的， 附属的； 后备的
heal	hiːl	hil	愈合， 痊愈， 恢复健康 / 使愈合，治愈，使康复；调停，消除
reserve	rɪ'zɜːv	rɪ'zɝv	保留，留存；预订 / 储备； 保留； 拘谨， 矜持； 替补队员， 后备部队； 自然保护区
somehow	'sʌmhau	'sʌmhaʊ	由于某种原因， 不知怎么的； 以某种方式
dive	daɪv	daɪv	跳水； 潜水；  俯冲
brick	brɪk	brɪk	砖， 砖块， 砖状物
sympathy	'sɪmpəθi	'sɪmpəθi	同情； 一致， 支持， 赞同
heap	hiːp	hip	堆， 大量
consumer	kən'sjuːmə	kən'sumɚ	消费者， 用户， 消耗者
rescue	'reskjuː	'rɛskju	营救， 救援
cripple	'krɪpl	'krɪpl	跛子；残疾人 / 使跛； 使残疾
highly	'haɪli	'haɪli	高度地， 极， 非常赞许地
brief	briːf	brif	简短的，短暂的 / 向…介绍基本情况，做…的提要 / 概要， 摘要
keyboard	'kiːbɔːd	'ki'bɔrd	键盘
initiative	ɪ'nɪʃətɪv	ɪ'nɪʃətɪv	主动性； 首创精神； 主动的行动， 倡议； 主动权
recover	rɪ'kʌvə	rɪ'kʌvɚ	重新获得， 挽回； 恢复
determine	dɪ'tɜːmɪn	dɪ'tɝmɪn	决意 / 决定；查明；使下决心
nature	'neɪtʃə	'netʃɚ	大自然； 本性； 性质
social	'səuʃl	'soʃl	社会的； 交际的， 社交的
medication	ˌmedi'keɪʃn	'mɛdɪ'keʃən	药物治疗； 药物
drill	drɪl	drɪl	钻， 打； 训练 / 钻头；操练，训练
intelligent	ɪn'telɪdʒənt	ɪn'tɛlɪdʒənt	聪明的， 理智的
whilst	waɪlst	hwailst	当…的时候
clerk	klɑːk	klɝk	店员， 办事员， 职员
lobby	'lɒbi	'lɑbi	向进行游说 / 大厅；休息室；院外活动集团
acknowledge	ək'nɒlɪdʒ	ək'nɑlɪdʒ	承认， 承认…的权威； 告知收到， 确认； 对…表示感谢， 报偿
equip	ɪ'kwɪp	ɪ'kwɪp	装备， 配备； 使有准备
radiation	ˌreɪdi'eɪʃn	,redɪ'eʃən	放射物， 辐射能； 辐射
Christian	'krɪstʃən	'krɪstʃən	基督教的 / 基督教徒，信徒
pulse	pʌls	pʌls	搏动， 跳动 / 脉搏；脉冲
luxury	'lʌkʃəri	'lʌɡʒəri	奢侈； 奢侈品
spiritual	'spɪrɪtʃuəl	'spɪrɪtʃʊəl	精神的， 心灵的； 宗教的
worthwhile	'wɜːθ'waɪl	'wɝθ'waɪl	值得花时间的， 值得做的
mould	məuld	məuld	霉，霉菌；模型，铸模；性格，气质 / 用模子做， 浇铸； 使形成， 把…铸造成
increasingly	ɪn'krɪːsɪŋli	ɪn'krisɪŋli	日益， 越来越多地
elbow	'elbəu	'ɛlbo	肘，肘部 / 用肘部， 用肘挤
salad	'sæləd	'sæləd	色拉， 凉拌菜
strategic	strə'tiːdʒɪk	strə'tidʒɪk	对全局有重要意义的， 关键的； 战略的
vary	'veəri	ˈveri	改变； 多样化
readily	'redɪli	'rɛdɪli	乐意地， 欣然地； 容易地； 很快地， 立即
stoop	stuːp	stʊp	俯身，弯腰；堕落，自贬 / 弯腰， 曲背
upper	'ʌpə	'ʌpɚ	上面的， 地位较高的
rocket	'rɒkɪt	'rɑkɪt	迅速上升， 猛涨 / 火箭
splendid	'splendɪd	'splɛndɪd	壮丽的； 极好的
county	'kaunti	'kaʊnti	郡， 县
respondent	rɪ'spɒndənt	rɪ'spɑndənt	回答者； 响应者； 被告
episode	'epɪsəud	'ɛpɪsod	一个事件； 插曲， 片段； 连续剧的一集
convenience	kən'viːniəns	kən'vinɪəns	方便； 便利设施
determination	dɪˌtɜːmɪ'neɪʃn	dɪˌtɜːrmɪˈneɪʃn	决心， 决定； 确定
discipline	'dɪsəplɪn	'dɪsəplɪn	纪律；训练；惩罚；学科 / 训练； 惩罚， 处罚
behalf	bɪ'hɑːf	bɪ'hæf	利益
evidently	'evɪdəntli	'ɛvɪdəntli	明显地， 显然
objective	əb'dʒektɪv	əb'dʒɛktɪv	客观的， 无偏见的 / 目标，目的
injure	'ɪndʒə	'ɪndʒɚ	伤害， 损害， 使遭受损伤
victimize	'vɪktɪmaɪz	'vɪktɪmaɪz	使受害， 使牺牲
exert	ɪg'zɜːt	ɪɡ'zɝt	尽； 运用
province	'prɒvɪns	'prɑvɪns	省； 领域， 范围
scandal	'skændl	'skændl	丑事， 丑闻； 流言蜚语； 反感， 愤慨
horrible	'hɒrəbl	ˈhɑːrəbl	令人恐惧的， 可怕的； 骇人听闻的； 极讨厌的， 使人不愉快的； 糟透的
estimate	'estɪmeɪt	'ɛstə,met	估计； 评价 / 估计； 评价， 看法
strengthen	'streŋθn	'strɛŋθn	加强， 巩固
drip	drɪp	drɪp	滴下，漏水 / 水滴； 滴水声
injury	'ɪndʒəri	'ɪndʒəri	损害， 伤害； 受伤处
exhibit	ɪg'zɪbɪt	ɪɡ'zɪbɪt	显示；陈列，展览 / 展览品
brand	brænd	brænd	品牌；烙印 / 铭刻， 打烙印于； 加污名于， 谴责
mushroom	'mʌʃruːm; 'mʌʃrum	'mʌʃrʊm	迅速成长 / 蘑菇
alcohol	'ælkəhɒl	'ælkəhɔl	酒精， 乙醇
choke	tʃəuk	tʃok	使窒息； 塞满， 塞住
proposal	prə'pəuzl	prə'pozl	提议， 建议； 求婚
inevitable	ɪn'evɪtəbl	ɪn'ɛvɪtəbl	不可避免的， 必然的
deny	dɪ'naɪ	dɪ'nai	否定， 否认； 拒绝…的要求
miserable	'mɪzrəbl	'mɪzrəbl	痛苦的； 悲惨的； 令人难受的
recreation	ˌrekri'eɪʃn	,rɛkrɪ'eʃən	娱乐活动， 消遣
subtract	səb'trækt	səb'trækt	减， 减去， 去掉
allowance	ə'lauəns	ə'laʊəns	津贴， 补贴； 零用钱
portable	'pɔːtəbl	'pɔrtəbl	便于携带的， 手提式的
ancient	'eɪnʃənt	ˈenʃənt	古代的， 古老的； 年老的， 看上去很老的
glory	'glɔːri	'ɡlɔri	光荣， 荣誉的事； 美丽
secondary	'sekəndri	'sɛkəndɛri	次要的， 第二的； 中等的； 辅助的， 从属的
mission	'mɪʃn	'mɪʃən	使命， 任务； 使团
attorney	ə'tɜːni	ə'tɝni	律师， 代理人
wander	'wɒndə	'wɑndɚ	漫游， 闲逛， 漫步； 偏离正道； 走神， 恍惚
adopt	ə'dɒpt	ə'dɑpt	收养； 采用， 采取； 正式通过， 批准
oppose	ə'pəuz	ə'poz	反对； 反抗
singular	'sɪŋgjələ	'sɪŋɡjəlɚ	单数的； 非凡的， 奇特的； 独一无二的
device	dɪ'vaɪs	dɪ'vaɪs	器械， 装置， 设备； 手段， 策略
mainframe	'meɪnfreɪm	'menfrem	主机， 大型机
motor	'məutə	'motɚ	发动机， 电动车
minus	'maɪnəs	'maɪnəs	负的 / 减 / 负数；减号
conservative	kən'sɜːvətɪv	kən'sɝvətɪv	保守的，守旧的；不时兴的，传统的 / 保守的人
access	'ækses	'æksɛs	接近；通道，入口；接近的机会 / 存取
conference	'kɒnfərəns	'kɑnfərəns	会议， 讨论会； 讨论， 商谈
activity	æk'tɪvəti	ækˈtɪvətɪ	活动； 活力； 行动
primitive	'prɪmətɪv	'prɪmətɪv	原始的，早期的；简单的；粗糙的 / 原人； 原始事物
advisable	əd'vaɪzəbl	əd'vaɪzəbl	明智的， 可取的
dormitory	'dɔːmətri	'dɔrmətɔri	集体寝室， 宿舍
overcome	ˌəuvə'kʌm	,ovɚ'kʌm	战胜， 克服； 压倒， 使受不了
cooperate	kəu'ɒpəreɪt	koʊˈɑːpəreɪt	合作， 协作； 配合
cabin	'kæbɪn	'kæbɪn	小屋； 船舱， 机舱
sum	sʌm	sʌm	共计 / 总数；金额；算术
current	'kʌrənt	kɝ​ənt	当前的， 通用的； 流行的， 流传的
heel	hiːl	hil	脚后跟， 踵； 后跟
variety	və'raɪəti	və'raɪəti	多样化； 种类； 变种
disturb	dɪ'stɜːb	dɪ'stɝb	打扰， 扰乱； 弄乱； 使不安
copper	'kɒpə	'kɑpɚ	铜； 铜币， 铜制器
persist	pə'sɪst	pɚ'sɪst	坚持， 持续
audio	'ɔːdiəu	'ɔdɪo	听觉的， 声音的
civilian	sə'vɪlɪən	sə'vɪlɪən	平民， 百姓
pump	pʌmp	pʌmp	泵 / 抽， 泵送， 打气
pierce	pɪəs	pɪrs	刺穿， 穿孔于
teenager	'tiːneɪdʒə	'tinedʒɚ	青少年
apart	ə'pɑːt	ə'pɑrt	成距离，相间隔；分开，除去 / 分离的， 分隔的
calendar	'kælɪndə	'kæləndɚ	日历， 历书， 历法
offensive	ə'fensɪv	ə'fɛnsɪv	冒犯的，无礼的；进攻的，攻击性的 / 进攻， 攻势
cartoon	kɑː'tuːn	kɑr'tun	卡通画， 幽默画； 动画片， 卡通片
speculate	'spekjuleɪt	'spɛkjə'let	推测， 推断； 投机， 做投机买卖
launch	lɔːntʃ	lɔntʃ	发射，投射，发动；使下水 / 发射； 下水
amid	ə'mɪd	ə'mɪd	在…中间， 在…之中， 被…围绕
beloved	bɪ'lʌvd	bɪ'lʌvd	所钟爱的， 所爱戴的
single	'sɪŋgl	'sɪŋɡl	单一的；独身的；单程的 / 单程票；
confirm	kən'fɜːm	kən'fɝm	证实， 肯定； 确认； 批准
cement	sɪ'ment	sə'mɛnt	水泥，胶泥 / 黏结； 巩固， 使团结
subway	'sʌbweɪ	'sʌbwe	地道； 地铁
gallon	'gælən	'ɡælən	加仑
acquaint	ə'kweɪnt	ə'kwent	使认识， 使了解
appoint	ə'pɔɪnt	ə'pɔɪnt	任命， 委任； 约定， 指定
elastic	ɪ'læstɪk	ɪ'læstɪk	有弹性的， 灵活的 / 松紧带
assist	ə'sɪst	ə'sɪst	援助， 帮助， 协助
vast	vɑːst	væst	巨大的， 大量的； 浩瀚的
intervene	ˌɪntə'viːn	,ɪntɚ'vin	干涉， 调停， 干预； 插入， 介入； 干扰， 打扰
undergraduate	ˌʌndə'grædʒuət	,ʌndɚ'ɡrædʒuət	大学本科生
symbol	'sɪmbl	'sɪmbl	象征； 符号， 标志
commercial	kə'mɜːʃl	kə'mɝʃəl	商业的， 商务的； 商品化的， 商业性的
joint	dʒɔɪnt	dʒɔɪnt	连接的； 共同的 / 接头，接缝；关节
reasonable	'riːznəbl	'riznəbl	通情达理的， 讲道理的； 合理的； 公道的； 尚好的， 过得去的
available	ə'veɪləbl	ə'veləbl	现成可使用的， 通用的； 可取的； 联系的； 可得到的
confine	kən'faɪn	kən'faɪn	限制， 使局限； 使不外出， 禁闭
advocate	'ædvəkeɪt；-ət	ˈædvəkeɪt；-et	拥护， 提倡， 主张 / 拥护者， 提倡者； 辩护者， 律师
frequency	'friːkwənsi	'frikwənsi	屡次； 次数， 频率
horizontal	ˌhɒrɪ'zɒntl	'hɔrə'zɑntl	地平的， 水平的
luggage	'lʌgɪdʒ	'lʌɡɪdʒ	行李
lick	lɪk	lɪk	舔，舔吃；打败，克服；轻拍，吞卷 / 舔； 少量， 少许
missile	'mɪsaɪl	'mɪsl	导弹， 飞弹， 投射物
dynamic	daɪ'næmɪk	daɪ'næmɪk	有活力的；动力的；不断变化的 / 动力； 动力学
satisfactory	ˌsætɪs'fæktəri	,sætɪs'fæktəri	令人满意的
military	'mɪlətri	'mɪlətɛri	军事的，军用的 / 军队， 武装力量
reluctant	rɪ'lʌktənt	rɪ'lʌktənt	不情愿的， 勉强的
generate	'dʒenəreɪt	'dʒɛnəret	发生， 引起； 生殖
unusual	ˌʌn'juːʒuəl	ʌnˈjuʒəl	不平常的， 少有的； 独特的， 与众不同的
sector	'sektə	'sɛktɚ	部门， 部分； 防御地段， 防区； 扇形
passion	'pæʃn	'pæʃən	激情， 热情； 酷爱
extreme	ɪk'striːm	ɪk'strim	极度的；末端的 / 极端， 过分
coil	kɔɪl	kɔɪl	卷，圈；线圈 / 卷
ensure	ɪn'ʃuə	ɪn'ʃʊr	保证； 保护
coordinate	kəʊ'ɔ:dɪneɪt	ko'ɔrdɪnet	同等的， 并列的 / 协调， 调节 / 坐标
organism	'ɔːgənɪzəm	'ɔrɡənɪzəm	生物， 有机体； 机体， 有机组织
athlete	'æθliːt	'æθlit	运动员， 体育家
epidemic	ˌepɪ'demɪk	,ɛpɪ'dɛmɪk	流行性的；传染的 / 流行病； 传播
suppose	sə'pəuz	sə'poz	猜想， 假定， 让； [常用于被动语态]期望， 认为应该
upright	'ʌpraɪt	'ʌpraɪt	挺直着， 竖立着 / 垂直的；正直的，诚实的
remarkable	rɪ'mɑːkəbl	rɪ'mɑrkəbl	值得注意的， 引人注目的； 异常的， 非凡的
brake	breɪk	brek	制动； 刹住， 用闸使放慢速度 / 闸，刹车
tube	tjuːb	tub	管， 电子管， 显像管
naval	'neɪvl	'nevl	海军的
failure	'feɪljə	'feljɚ	失败， 失败的人； 失灵， 故障； 不履行
accountancy	ə'kauntənsi	ə'kaʊntənsi	会计工作； 会计学
forge	fɔːdʒ	fɔrdʒ	打制， 锻造； 伪造
carpet	'kɑːpɪt	'kɑrpɪt	地毯
solve	sɒlv	sɑlv	解答； 解释； 解决
hint	hɪnt	hɪnt	暗示， 示意 / 暗示，示意；细微的迹象；建议
knot	nɒt	nɑt	打结 / 结；节疤；节 / 把…打成结
demonstrate	'demənstreɪt	'dɛmən'stret	说明； 论证； 表露
region	'riːdʒən	'ridʒən	地区， 地带， 区域； 范围， 幅度
support	sə'pɔːt	sə'pɔrt	支撑；支持；供养；证实 / 支持， 支撑物， 支持者
yearly	'jɜːli;'jɪəli	'jɪrli	一年一度地 / 每年的
deceive	dɪ'siːv	dɪ'siv	欺骗， 蒙蔽， 行骗
saucer	'sɔːsə	'sɔsɚ	茶托， 碟子
hire	'haɪə	'haɪɚ	租用； 雇用
kid	kɪd	kɪd	戏弄， 开玩笑 / 小孩；年轻人
donkey	'dɔŋki	ˈdɑŋkɪ	驴； 笨蛋
destination	ˌdestɪ'neɪʃn	,dɛstɪ'neʃən	目的地， 终点， 目标
vertical	'vɜːtɪkl	'vɝtɪkl	垂直的， 竖式的
learning	'lɜːnɪŋ	'lɝnɪŋ	学习； 学问， 知识
monument	'mɒnjumənt	'mɑnjumənt	纪念碑， 纪念馆； 历史遗迹
misconception	ˌmɪskən'sepʃn	'mɪskən'sɛpʃən	误解
damp	dæmp	dæmp	潮湿的，微湿的 / 潮湿，湿气 / 使潮湿； 使沮丧； 抑制
vivid	'vɪvɪd	'vɪvɪd	鲜艳的； 生动的， 栩栩如生的
honey	'hʌni	'hʌni	蜜， 蜂蜜； 甜， 甜蜜； [常用于称呼] 宝贝儿
screw	skruː	skru	螺丝 / 固定， 拧紧
gap	gæp	ɡæp	缺口； 间隔； 差距； 缺陷
missing	'mɪsɪŋ	'mɪsɪŋ	缺掉的， 失踪的
emphasize	'emfəsaɪz	'ɛmfəsaɪz	强调， 着重
virtue	'vɜːtʃuː	'vɝtʃʊ	善， 美德； 优点， 长处
normal	'nɔːml	'nɔrml	正常的， 平常的； 正规的， 规范的
socialist	'səuʃəlɪst	'soʃəlɪst	社会主义者
gradual	'grædʒuəl	'ɡrædʒuəl	逐渐的， 渐进的； 坡度平缓的
figure	'fɪgə	'fɪɡjɚ	出现； 合乎情理； 计算； 认为， 猜想 / 数字；人物；算术；体形，体态；轮廓；画像，塑像；图，图形
ore	ɔː	ɔr	矿， 矿石
slight	slaɪt	slaɪt	轻微的，微小的 / 侮慢；轻视，冷落
previous	'priːviəs	'privɪəs	先的， 前的； 以前的
transmit	trænz'mɪt; træns'mɪt	trænzˈmɪt	传送， 传递； 传染； 播送， 发射
socialism	'səuʃəlɪzəm	'soʃəlɪzəm	社会主义
consumption	kən'sʌmpʃn	kən'sʌmpʃən	消耗， 消费
argue	'ɑːgjuː	'ɑrgjʊ	争辩， 争论 / 争论，争辩，辩论；主张；说服
technology	tek'nɒlədʒi	tɛkˈnɑlədʒɪ	工艺学； 工艺， 技术
weaken	'wiːkən	'wikən	削弱， 变弱
voltage	'vəultɪdʒ	'voltɪdʒ	电压
damn	dæm	dæm	该死，见鬼〔表示很生气或失望〕 / 非常，很 / 该死的〔表示对某人或某事物生气〕
superior	sjuː'pɪəriə	sʊˈpɪrɪɚ	上级的，较高的；优越的；有优越感的，高傲的 / 上级， 长官
location	ləu'keɪʃn	lo'keʃən	位置， 场所； 外景拍摄地
compensation	ˌkɒmpen'seɪʃn	,kɑmpɛn'seʃən	补偿， 赔偿
bankrupt	'bæŋkrʌpt	'bæŋkrʌpt	破产的
punctual	'pʌŋktʃuəl	'pʌŋtʃʊəl	严守时刻的， 准时的
advertise	'ædvətaɪz	'ædvɚtaɪz	为…做广告， 宣传； 公告； 登广告
compromise	'kɒmprəmaɪz	'kɑmprəmaɪz	妥协； 危及； 放弃 / 妥协，和解，折中办法
sack	sæk	sæk	麻袋，包；解雇；洗劫，劫掠 / 解雇； 洗劫， 劫掠
software	'sɒftweə	'sɔftwɛr	软件
seminar	'semɪnɑː	'sɛmɪnɑr	研究班， 研讨会
comparative	kəm'pærətɪv	kəm'pærətɪv	比较的， 相对的
competition	ˌkɒmpə'tɪʃn	,kɑmpə'tɪʃən	竞争， 比赛
fruitful	'fruːtful	'frutfl	多产的， 肥沃的
react	ri'ækt	ri'ækt	反应， 作出反应
dragon	'drægən	'dræɡən	龙
hesitant	'hezɪtənt	'hɛzɪtənt	犹豫的； 吞吞吐吐的
beyond	bɪ'jɒnd	bɪ'jɑnd	在更远处， 再往后 / 在…的那边，远于；迟于；越出
hell	hel	hɛl	地狱； 极大的痛苦
feedback	'fiːdbæk	'fidbæk	回授， 反馈， 反应
hazard	'hæzəd	'hæzɚd	危险；公害 / 尝试着做； 冒…风险
justify	'dʒʌstɪfaɪ	'dʒʌstə'fai	证明…是正当的
voluntary	'vɒləntri	'vɑləntɛri	自愿的， 志愿的
connection	kə'nekʃn	kə'nɛkʃən	联系， 关系； 连接， 衔接； 连贯性； 熟人， 关系
proof	pruːf	pruf	耐…的， 能防…的 / 证据，证明；校样，样张
timber	'tɪmbə	'tɪmbɚ	木材， 原木； 大木料， 栋木
roar	rɔː	rɔr	吼叫，怒号，咆哮；轰鸣；大声喊出，大声表示 / 呐喊声， 咆哮声， 吼叫声； 轰鸣
presence	'prezns	'prɛzns	出席， 到场； 存在； 仪表， 仪态
phase	feɪz	fez	阶段； 方面； 相， 相位
surrounding	sə'raundɪŋ	sə'raʊndɪŋ	附近的；四周的
efficiency	ɪ'fɪʃnsi	ɪˈfɪʃənsɪ	效率； 功效， 效能
overhead	əʊvə'hed	,ovɚ'hɛd	在头顶上 / 在头顶上的，架空的 / 经常费用， 管理费用
contract	'kɒntrækt	'kɑntrækt	缩小； 订合同； 感染， 染上 / 契约， 合同
conclude	kən'kluːd	kən'klud	推断出， 推论出； 结束， 终了； 缔结， 议定
comprehension	ˌkɒmprɪ'henʃn	,kɑmprɪ'hɛnʃən	理解， 理解力， 领悟； 理解力测验
beggar	'begə	'bɛɡɚ	乞丐 / 使贫穷
leather	'leðə	'lɛðɚ	皮革， 皮革制品
comb	kəum	kom	梳子；鸡冠，冠状物 / 梳理； 在…搜寻； 彻底搜查
innovative	'ɪnəveɪtɪv	'ɪnəvetɪv	创新的， 革新的
insight	'ɪnsaɪt	'ɪn'saɪt	洞察力； 洞悉； 深刻见解
fabric	'fæbrɪk	'fæbrɪk	织物， 纺织品； 结构
revolutionary	ˌrevə'luːʃənəri	'rɛvə'lʊʃə'nɛri	革命的，革新的 / 革命者
following	'fɒləuɪŋ	'fɑloɪŋ	接着的，下列的 / 一批追随者
exact	ɪg'zækt	ɪɡ'zækt	确切的，精确的 / 强求， 索取
indoor	'ɪndɔː	'ɪndɔr	在室内， 在户内 / 室内的
force	fɔːs	fɔrs	强迫；用力推动，用力打开 / 军队， 兵力； 暴力， 武力； 力， 力气； 影响力， 效力
centigrade	'sentɪgreɪd	'sɛntɪɡred	百分度的； 摄氏的
sexual	'sekʃuəl	sɛkʃʊəl	性的， 两性的； 性别的
sympathetic	ˌsɪmpə'θetɪk	,sɪmpə'θɛtɪk	同情的； 和谐的； 赞同的， 支持的； 合意的
freight	freɪt	fret	货运；货物；运费 / 运送
range	reɪndʒ	rendʒ	变动； 漫游， 四处搜索； 使排列成行 / 一系列；范围；射程，距离；脉；射击场
distribution	ˌdɪstrɪ'bjuːʃn	'dɪstrə'bjʊʃən	分发， 分配； 分布
tyre	'taɪə	'taɪɚ	轮胎， 车胎
derive	dɪ'raɪv	dɪ'raɪv	取得； 起源
capacity	kə'pæsəti	kə'pæsəti	容量； 能力， 才能； 能量； 身份， 地位
cope	kəup	kop	应付， 处理
overseas	ˌəuvə'siːz	,ovɚ'siz	在海外 / 在海外的
impress	ɪm'pres	ɪm'prɛs	给人印象，引人注目 / 给…深刻印象；印，压印 / 印记； 特征
confess	kən'fes	kən'fɛs	供认， 坦白； 承认
leak	liːk	lik	漏；泄露 / 漏洞
ghost	gəust	ɡost	鬼， 灵魂， 鬼魂
feature	'fiːtʃə	'fitʃɚ	起重要作用 / 特征，特色；面貌；特写，专题节目；故事片 / 突出；由…主演
lean	liːn	lin	倾斜；屈身；靠 / 瘦的； 贫瘠的
flat	flæt	flæt	平直地； 直截了当地 / 平的；固定的；漏气的；平淡的；沉闷的；浅的 / 一套房间，单元住宅
recall	rɪ'kɔːl	'rikɔl	回忆； 召回， 叫回； 收回， 撤销
leap	liːp	lip	跳，跃 / 跳跃； 骤变
waterproof	'wɔːtəpruːf	'wɔtɚpruf	不透水的， 防水的
barber	'bɑːbə	'bɑrbɚ	理发师
precise	prɪ'saɪs	prɪ'saɪs	精确的， 准确的； 严谨的
sensible	'sensəbl	'sɛnsəbl	明智的； 合情理的； 有知觉的
objection	əb'dʒekʃn	əb'dʒɛkʃən	反对， 异议； 反对的理由
dispute	dɪ'spjuːt; 'dɪspjuːt	'dɪs'pjʊt	争论， 争执； 对…表示异议 / 争论
precious	'preʃəs	'prɛʃəs	珍贵的， 宝贵的
observation	ˌɒbzə'veɪʃn	,ɑbzɚ'veʃən	注意， 观察； 言论， 评论； 观察资料
tremble	'trembl	'trɛmbl	发抖，哆嗦；摇动 / 颤抖； 摇晃， 摇动
suspect	sə'spekt	sʌspɛkt; (for v.) səˈspɛkt	可疑的， 不信任的 / 疑有；推测；对…表示怀疑 / 嫌疑犯，可疑分子
apologize	ə'pɒlədʒaɪz	ə'pɑlədʒaɪz	道歉， 谢罪， 认错
inhabitant	ɪn'hæbɪtənt	ɪn'hæbɪtənt	居民， 住户
fraction	'frækʃn	'frækʃən	小部分； 片断； 分数
filter	'fɪltə	'fɪltɚ	过滤，透；走漏 / 滤纸， 过滤嘴
sunlight	'sʌnlaɪt	'sʌnlaɪt	日光， 阳光
site	saɪt	saɪt	地点，场所 / 使坐落在； 设置
emotion	ɪ'məuʃn	ɪ'moʃən	情感， 感情； 激动
massive	'mæsɪv	'mæsɪv	大的， 大而重的； 大块的； 大量的， 大规模的
cease	siːs	sis	停止， 终止
assess	ə'ses	ə'sɛs	对估价； 评价， 评论
asset	'æset	'æsɛt	资产， 财产； 有价值的特性或技能， 优点
owe	əu	o	欠； 应把…归功于； 感激， 感恩
scarce	skeəs	skɛrs	缺乏的， 不足的； 稀少的， 罕见的
minimum	'mɪnɪməm	'mɪnɪməm	最低的， 最小的 / 最低限度；最小量
queue	kjuː	kju	排队等候 / 长队，行列
mathematical	ˌmæθə'mætɪkl	,mæθə'mætɪkl	数学的
apology	ə'pɒlədʒi	ə'pɑlədʒi	道歉， 认错， 谢罪
magic	'mædʒɪk	'mædʒɪk	有魔力的； 魔术的 / 魔法，魅力
argument	'ɑːgjumənt	'ɑrɡjumənt	争论， 辩论； 理由； 说理， 论证
reveal	rɪ'viːl	rɪ'vil	揭露， 泄露； 展现， 显示
data	'deɪtə	'detə	资料，数据
theoretical	ˌθɪə'retɪkl	,θiə'rɛtɪkəl	理论的
adequate	'ædɪkwət	ˈædɪkwət	足够的； 可以胜任的
utter	'ʌtə	'ʌtɚ	完全的，彻底的 / 发出， 说， 讲
onion	'ʌnjən	'ʌnjən	洋葱； 洋葱类植物
vibrate	vaɪ'breɪt	vaɪ'breɪt	颤动
drum	drʌm	drʌm	有节奏地敲击 / 鼓，鼓状物；圆桶
sausage	'sɒsɪdʒ	'sɔsɪdʒ	香肠， 腊肠
hopeful	'həupfl	'hopfl	有希望的
tremendous	trə'mendəs	trə'mɛndəs	极大的， 非常的； 精彩的， 了不起的
condense	kən'dens	kən'dɛns	冷凝， 凝结； 浓缩， 压缩， 简缩
barrier	'bæriə	'bærɪɚ	栅栏； 检票口； 屏障； 障碍， 隔阂
realistic	ˌriːə'lɪstɪk	,riə'lɪstɪk	现实的； 实际可行的； 现实主义的； 逼真的
justice	'dʒʌstɪs	'dʒʌstɪs	正义， 公正； 司法
create	kri'eɪt	krɪ'et	创造； 引起， 产生
criminal	'krɪmɪnl	'krɪmɪnl	犯罪的， 刑事的 / 犯人，罪犯，刑事犯
tag	tæg	tæɡ	尾随 / 附加语；标签 / 给…加上标签
notebook	'nəutbuk	'notbʊk	笔记本
curious	'kjuəriəs	'kjʊrɪəs	好奇的； 奇怪的
indirect	ˌɪndə'rekt; ˌɪndaɪ'rekt	,ɪndə'rɛkt	间接的， 婉转的
individual	ˌɪndɪ'vɪdʒuəl	ˌɪndəˈvɪdʒʊəl	个别的；独特的 / 个人， 个体
resource	rɪ'sɔːs; rɪ'zɔːs	'risɔrs	资源； 财力； 应付办法， 谋略
ugly	'ʌgli	'ʌɡli	丑陋的； 可怕的
nuisance	'njuːsns	'nusns	讨厌的东西
tax	tæks	tæks	税，税款；负担 / 对…征税； 使负担重， 使费尽力气
earthquake	'ɜːθkweɪk	'ɝθ'kwek	地震， 大震荡
excitement	ɪk'saɪtmənt	ɪk'saɪtmənt	刺激， 激动， 兴奋； 令人兴奋的事， 刺激的因素
nightmare	'naɪtmeə	'naɪt'mɛr	噩梦； 可怕的事物， 无法摆脱的恐惧
cord	kɔːd	kɔrd	细绳， 粗线， 索； 灯芯绒裤
ending	'endɪŋ	'ɛndɪŋ	结尾， 结局； 死亡
core	kɔː	kɔr	果实的心； 核心， 要点
council	'kaunsl	'kaʊnsl	理事会， 委员会
enforce	ɪn'fɔːs	ɪn'fɔrs	实施， 执行； 强制， 强迫， 迫使
embassy	'embəsi	'ɛmbəsi	大使馆； 大使馆全体成员
departure	dɪ'pɑːtʃə	dɪ'pɑrtʃɚ	离开， 起程， 出发； 背离， 违背
dash	dæʃ	dæʃ	猛冲，击碎 / 使猛撞，飞奔；溅 / 猛冲； 破折号
concrete	'kɒŋkriːt	'kɑŋkrit	实在的， 具体的 / 混凝土；具体物
penalty	'penəlti	'pɛnəlti	处罚， 惩罚； 罚金
sociology	ˌsəusi'ɒlədʒi	,sosɪ'ɑlədʒi	社会学
link	lɪŋk	lɪŋk	连接，联系 / 环节， 联系， 纽带
flee	fliː	fli	逃走， 逃掉， 逃离； 避开， 逃避
distinct	dɪ'stɪŋkt	dɪ'stɪŋkt	与其他不同的； 清楚的， 明显的
scale	skeɪl	skel	大小，规模；等级，级别；天平，磅秤；比例；刻度，标度；鳞 / 攀登， 爬越
recovery	rɪ'kʌvəri	rɪ'kʌvəri	恢复， 痊愈； 追回， 寻回， 收复
hedge	hedʒ	hɛdʒ	用篱笆围； 避免直接回答 / 篱笆，树篱；障碍物
tune	tjuːn	tun	调子；和谐 / 调整， 调节； 为调音
weep	wiːp	wip	哭泣， 流泪； 渗出
aware	ə'weə	ə'wɛr	知道的， 意识到的
drama	'drɑːmə	'drɑmə	戏剧， 剧本； 戏剧性事件
security	sɪ'kjuərəti	sə'kjʊrəti	安全， 保障； 抵押品； 证券
limp	lɪmp	lɪmp	软的；不强壮的 / 〔因一腿受伤而〕跛行，一瘸一拐地走 / 跛行
award	ə'wɔːd	ə'wɔrd	奖，奖品；判定 / 授予， 给予； 判给， 裁定
organize	'ɔːgənaɪz	ɔrɡənˌaɪz	组织， 把…编组； 使有条理
marriage	'mærɪdʒ	'mærɪdʒ	结婚， 婚姻； 婚礼
stove	stəuv	stov	炉， 火炉， 电炉
alarm	ə'lɑːm	ə'lɑrm	惊恐；忧虑；警报 / 使惊恐； 使担心
weed	wiːd	wid	除草 / 杂草，野草
continual	kən'tɪnjuəl	kən'tɪnjuəl	连续的； 频频的
herd	hɜːd	hɝd	兽群，牧群 / 放牧
limb	lɪm	lɪm	肢， 臂， 腿； 树枝
balloon	bə'luːn	bə'lun	气球， 玩具气球
motion	'məuʃn	'moʃən	打手势， 示意 / 运动；手势，眼色，动作；提议
limited	'lɪmɪtɪd	'lɪmɪtɪd	有限的
idle	'aɪdl	'aɪdl	空闲的，懒散的；无用的 / 虚度， 无所事事
confidence	'kɒnfɪdəns	'kɑnfɪdəns	信任， 信赖； 信心， 自信
arbitrary	'ɑːbɪtrəri	ˈɑːrbətreri	随心所欲的， 专断的
fearful	'fɪəfl	'fɪrfəl	害怕的， 可怕的； 不安的， 忧虑的
accent	'æksənt	'æksɛnt	口音， 腔调； 重音
passive	'pæsɪv	'pæsɪv	被动的， 消极的
fertilizer	'fɜːtəlaɪzə	'fɝtəlaɪzɚ	肥料
lorry	'lɒri	'lɔri	运货汽车， 卡车
carrier	'kæriə	'kærɪɚ	运输工具， 运载工具； 带菌者； 载重架， 置物架
fragment	'frægmənt	'fræɡmənt	成碎片 / 碎片，破片，碎块
corresponding	ˌkɒrə'spɒndɪŋ	,kɔrə'spɑndɪŋ	相应的， 符合的
response	rɪ'spɒns	rɪ'spɑns	回答， 答复； 反应， 响应
treaty	'triːti	'triti	条约， 协议， 协定
responsive	rɪ'spɒnsɪv	rɪ'spɑnsɪv	响应的； 敏感的， 易受影响的
ounce	auns	aʊns	盎司
challenge	'tʃælɪndʒ	'tʃælɪndʒ	挑战；邀请比赛；艰巨的任务；怀疑，质问 / 反对， 公然反抗； 向…挑战； 对…质疑
emit	i'mɪt	ɪ'mɪt	散发； 发射； 发表
category	'kætəgəri	'kætəɡɔri	种类， 类， 类别
rival	'raɪvl	'raɪvl	竞争的，对抗的 / 竞争对手，敌手；可与匹敌的人 / 与 …竞争； 与…匹敌， 比得上
intend	ɪn'tend	ɪn'tɛnd	想要， 打算； 意思是； 打算使
snap	snæp	snæp	咔嚓折断，啪地绷断；吧嗒一声；猛咬；厉声说话，怒声责骂 / 仓促的， 突然的 / 吧嗒声；快照
